_blov_ = [
blow	blovi	v.ntr as the wind	w
blew	blovis	v.tr	w
had blown	blovis	v.tr	w
draft	trablovo	n. flow of air	w
gust	bloveto	n. small blows of air	
blast	blovego	n.	w
blown	blovita	adj.	
inflate	enblovi	v.tr blow up like a balloon	w
]

_vek_ = [
waken	veki	v.tr	w
awaken	veki	v.tr to wake someone else	w
awake	vekiĝi	v.ntr wake up	w
awaken	vekiĝi	v.ntr to become awake	w
would wake up	vekiĝus	v.ntr	
awakening	vekiĝo	n.	w
]

_strang_ = [
strange	stranga	adj.	w
funny	stranga	adj. strange or curious	w
peculiar	stranga	adj.	w
queer	stranga	adj.	w
weird	stranga	adj.	w
odd	strange	adv. strange	w
oddly	strange	adv.	w
peculiarly	strange	adv.	w
strangely	strange	adv.	w
oddity	strangaĵo	n. an odd thing	w
strangest	plej stranga	adj.	
stranger	pli stranga	phr.	
]

_cel_ = [
goal	celo	n.	w
mean	celi	v.tr idiomatic signaling of intention	
meant	celis	v.tr
object	celo	n. of action	
point	celo	n. of action	
target	celo	n.	
aim	celi	v.tr	w
aim for	celi	v.tr	s
aimless	sencela	adj.	w
]

_ĵet_ = [
cast off	forĵeti	v.tr	
cast	ĵeti	v.tr
fling	ĵeti	v.tr	w
throw down	terĵeti	v.tr	w
thrown	ĵetata	adj.	
toss	ĵeti	v.tr	
toss	ĵeto	n.	
threw it in	enĵetis ĝin	phr.	
throw	ĵeti	v.tr	
throw	ĵeto	n.	
throw out	forĵeti	v.tr	
pitch	ĵeto	n.	w
throw off	deĵeti	v.tr	w
moon-cast	lune ĵetita	adj.	
dashed full-tilt against	plene sin ĵetis kontraŭ	phr.	
]

_ĝust_ = [
accurate	ĝusta	adj.	
correct	ĝusta	adj.	
right	ĝusta	adj. proper	
very	ĝuste	adv. exactly the same way	
properly	ĝuste	adv.	
just	ĝuste	adv. exactly	
adjust	ĝustigi	v.tr	w
wrong	malĝusta	adj. improper	
wrongly	malĝuste	adv. improperly	
wrong	malĝustaĵo	n. a wrong thing
rather	pli ĝuste	adv. more precisely	
]

_pas_ = [
elapse	pasi	v.ntr	w
go past	preterpasi	v.tr	w
pass	preterpasi	v.tr pass by, esp by auto	
passed me by	preterpasis min	phr.	
passes	pasas	v.tr.ntr	
passing	pasanta	adj. eg passing years	
passage	pasejo	n.	
past	pasinta	adj.	
past	pasinteco	n.	
bygone	pasinta	adj.	w
]

_vojaĝ_ = [
voyage	vojaĝo	n. 	w
journey	vojaĝo	n.	w
]

_voj_ = [
way	vojo	n. path	w
lane	vojeto	n. small country road	
road	vojo	n.	
path	vojeto	n.	w
pike	vojo	n. road	
on the way back	survoje reen	phr.	
tramway	tramvojo	n.	w
causeway	digvojo	n. 	w
halfway	duonvoje	adv.	w
on the way	survoje	adv.	w
on my way	survoje	adv.	w
path	vojo	n. 	w
lines of rails	relvojoj	n. railway lines	s
parting of the ways	disiĝo de la vojoj	phr.	w
]

_halt_ = [
halt	halti	v.ntr come to a halt	w
stop	halti	v.ntr	
breaks off	halti	v.ntr cease esp temporarily	w
stop dead	haltu kiel mortinte	adv.	
stopped	haltigis	v.tr stopped a thing in a seemingly temporary way	
desist	halti	v.ntr
]

_don_ = [
give	doni	v.tr	w
grant	doni	v.tr give	w
gave	donis	v.tr	
would give	donus	v.tr	
has given	donis	v.tr	
have given	donis	v.tr	
add	aldoni	v.tr	
added	aldonis	v.tr	
return	redoni	v.tr give back	w
publish	eldoni	v.tr	w
convey	transdoni	v.tr	w
is given up	fordonita	adj.	
hands	transdonas	v.tr hands over to	
vote	voĉdoni	v.tr.ntr	w
given	donita	adj.	
]

_donac_ = [
bestow	donaci	v.tr	w
boon	donaco	n. gift	w
present	donaco	n. gift	
gift	donaco	n.	w
]

_pardon_ = [
forgive	pardoni	v.tr forgive someone or something	
forgiven	pardonita	adj.	
pardon	pardono	n.	w
forgiveness	pardono	n.	w
I’m sorry	pardonu min	phr.	w
beg your pardon	petas vian pardonon	phr.	w
]

_ordon_ = [
bade	ordonis	v.tr ordered	w
order	ordono	n. command	w
warrant	ordono	n. judicial writ	w
]

_lert_ = [
skilful	lerta	adj.	w
quick to learn	lerta	adj.	
adept	lerta	adj.	w
clever	lerta	adj.	w
cleverly	lerte	adv.	
awkwardly	mallerte	adv.	
lamely	mallerte	adv. clumsily	
quick learner	lertulo	n.	w
clever person	lertulo	n.	
skill	lerteco	n.	
]

_lev_ = [
raise	levi	v.tr move a thing up	w
lift	levi	v.tr	w
lift	leviĝi	v.ntr	
rise	leviĝi	v.ntr	w
is rising	leviĝas	v.ntr	
are rising	leviĝas	v.ntr	
rose	leviĝis	v.ntr	
rising	leviĝanta	adj.	
rising	leviĝante	adv.	
rising	leviĝanta	adj.	
risen	leviĝinta	adj.	
risen up	leviĝinta	adj.	
lever	levilo	n.	w
lifting	levanta	adj.	
uplifting	levo	n. act of lifting something up	w
pry up	perforte levi	phr.	
rising	leviĝo	n.	w
]

_mov_ = [
move	movi	v.tr	
movement	movo	n.	
motion	movo	n.	
set in motion	ekmovi	v.tr	
bestir	ekmoviĝi	v.ntr	w
start	ekmovo	n. abrupt motion	w
inert	senmove	adv.	w
stillness	senmoveco	n.	w
moving	moviĝante	adv.	
start	ekmoviĝi	v.ntr begin to move	
still	senmove	adv. not moving	w
motionless	senmova	adj.	
moves	moviĝas	v.ntr	
moves back	retromoviĝas	v.ntr	
moving	movanta	adj.	
moved	moviĝinta	adj.	
immovably	nemoveble	adv.	w
]

_rapid_ = [
hurried	rapidis	v.ntr	
hurries	rapidas	v.ntr	
quick	rapida	adj.	w
swift	rapida	adj.	w
quickly	rapide	adv.	w
swiftly	rapide	adv.	w
hurrying	rapidanta	adj.	
rapidly	rapide	adv.	w
moves faster	rapidiĝas	v.ntr	
swifter and swifter	pli kaj pli rapide	adv.	
slow	malrapida	adj.	w
slowing down	malrapidiĝante	adv.	
slowly	malrapide	adv.	
did wax somewhat slow	iomete malrapidis	phr.	
]

_rilat_ = [
affect	rilati	v.tr.ntr be connected to, related to, entailed by	
relate to	rilati	v.tr.ntr	
make reference to	rilati	v.tr.ntr (+al)	
have a connection with	rilati	v.tr.ntr (+al)	
concern	rilati	v.tr.ntr is related to	
be entailed by	rilati	v.tr.ntr	
had much to do with	tre rilatis al	phr.	
]

_ven_ = [
come	veni	v.ntr	w
come on	venu	v.ntr	w
came	venis	v.ntr	w
have come	venis	v.ntr	w
gather	kunveni	v.ntr	w
meeting	kunveno	n.	
roll up	alveni	v.tr	
come out	elveni	v.ntr	
return	reveni	v.ntr	
closing in	alvenanta	adj.	
to be back	reveninta	phr. to have returned	
come down	veni malsupren	phr.	w
unwelcome	malbonvena	adj.	w
am come	estas veninta	phr.	w
coming	alveno	n. arrival	w
would come	venus	v.ntr	w
came out	elvenis	v.ntr	w
was to come	estis venonta	phr.	s
]

_konven_ = [
appropriate	konvena	adj.	w
fitting	konvena	adj.	w
seemly	konvena	adj.	w
well-suited	konvena	adj.	s
becomes	konvenas	v.ntr (+al) is well suited to in an enhancing way	
]

_fest_ = [
celebrate	festi	v.tr	
celebration	festo	n.	w
festive	festa	adj.	w
party	festo	n.	
Candlemas	Kandelfesto	n.	w
]

_festen_ = [
feast	festeni	v.ntr attend a party	w
feast	festeno	n.	
have a party	festeni	v.ntr	s
make merry	festeni	v.ntr	w
dinner party	festeno	n.	
gala	festeno	n.	
attend a party	festeni	v.ntr	s
banquet	festeno	n.	
]

_okaz_ = [
happen	okazi	v.ntr	w
instance	okazo	n.	
occasion	okazo	n.	w
opportunity	okazo	n.	w
took place	okazis	v.ntr	w
affair	okazaĵo	n. event	w
anyhow	ĉiaokaze	adv.	w
at any rate	ĉiuokaze	adv.	w
may it happen	ĝi okazu	phr. expression of hope that it happens	
it chanced	hazarde okazis	phr. it happened to occur	
]

_sovaĝ_ = [
wild	sovaĝa	adj.	w
wilderness	sovaĝejo	n.	
wildly	sovaĝe	adv.	
wilds	sovaĝejo	n. wilderness	
savage	sovaĝa	adj.	w
ferocity	sovaĝeco	n.	w
wildest	plej sovaĝa	adj. 	w
]

_rid_ = [
laugh	ridi	v.ntr	w
smile	rideti	v.ntr	w
smirk	rideti	v.ntr	w
smile	rideto	n.ntr	w
snicker	subridi	v.ntr	
snicker	klukridi	v.ntr	w
snicker	subridaĉi	v.ntr	
laugher	ridanto	n.	w
laughter	ridado	n.	
ludicrous	ridindeco	n. ridiculousness	
ridiculous	ridinda	adj.	
sniggering	ridaĉado	n.	
titter	klukridi	v.ntr	w
titter	subridaĉi	v.ntr	w
titter	subridi	v.ntr	w
tittering	subridado	n.	
funny	ridinda	adj. worthy  of mocking	
giggle	klukridi	v.ntr	w
giggle	subridaĉi	v.ntr	w
giggle	subridi	v.ntr	w
smiles	ridetas	v.ntr	w
smiling	ridetante	adv.	w
sly smile	subrideti	v.ntr	s
with a smile	ridetante	adv.	s
frowning	malridetante	adv.	
]

_hav_ = [
have	havi	v.tr	w
hold	havi	v.tr	
got	havas	v.tr	
has	havas	v.tr	
have	havas	v.tr	w
haven’t	ne havas	phr.	
had	havis	v.tr	
make available	havigi	v.tr	
had	havinta	adj.	
of	havanta	adj.having	
having	havante	adv.	
provide	havigi	v.tr	
contain	enhavi	v.tr	w
caught	ekhavita	adj. as in a disease was caught	
share	kunhavigi	v.tr	
sharer	kunhavanto	n.	w
had I	se mi havus	phr.	s
indispensable	nemalhavebla	adj.	w
]

_ŝat_ = [
like	ŝati	v.tr	
value	ŝati	v.tr to value	
fond	ŝata	adj.	w
appreciate	ŝati	v.tr to appreciate	
appreciated	ŝatata	adj.	
much liked	ŝatata	adj.	
cherished	ŝatita	adj.	w
best liked	plej ŝatata	adj.	
favorite	plej ŝatata	adj.	
]

_trov_ = [
find	trovi	v.tr	w
found	trovis	v.tr	w
be found	troviĝi	v.ntr	
be findable	trovebli	v.ntr	
newfound	nove trovita	adj.	w
just chanced to be	hazarde troviĝis	phr.	
]

_mank_ = [
miss	manki	v.ntr	w
be lacking	manki	v.ntr	
be missed	manki	v.ntr	
be missing	manki	v.ntr	
be needed	manki	v.ntr	
defect	manko	n.	
lack	manko	n.	w
missing part	manko	n.	
]

_obe_ = [
obey	obei	v.tr + 'al'	
obeys	obeas	v.tr	
obedient	obeema	adj.	w
]

_ferm_ = [
ajar	malfermetita	adj. having been slightly opened	w
ajar	malfermete	adv. being pushed slightly open	w
opens	malfermas	v.tr	
opens	malfermiĝas	v.ntr	
open	malferma	adj. eg an open opportunity, open as an defining feature	w
open	malfermi	v.tr cause to be open	w
open	malfermita	adj. eg door that has been opened	w
opened	malfermiĝis	v.ntr	
will open	malfermos	v.tr	
close	fermiĝi	v.ntr become in a closed state	
open	malfermiĝi	v.ntr become open	w
opening	malfermaĵo	n.	w
shut	fermite	adv.	w
]

_pur_ = [
neat	pura	adj. clean	
pure	pura	adj.	w
unadulteratedly	pure	adv.	
pollution	malpurado	n.	
dirt	malpuraĵo	n.	
pollution	malpuraĵo	n.	
filth	malpuraĵo	n.	
muck	malpuraĵo	n.	w
pollution	malpureco	n.	
pollution	malpuro	n.	
uncleanliness	malpurado	n.	
uncleanliness	malpureco	n.	
uncleanliness	malpuro	n.	
purified	purigita	adj.	
]

_fort_ = [
strong	forta	adj.	
hefty	forta	adj. strong	
frail	malforta	adj.	w
faint	malforta	adj.	w
weak	malforta	adj.	
faintly	malforte	adv.	w
strengthen	fortigi	v.tr	
strengthened	fortigita	adj.	
grew faint	plimalfortiĝis	v.ntr	
braced myself	fortigis min	phr.	
make weak	malfortigi	v.tr	
strength	forto	n.	w
force	forto	n.	
violence	perforto	n.	w
violent	perforta	adj.	w
overwrought	superfortita	adj.	w
weakness	malforteco	n.	w
ravish	perforti	v.tr	
rape	perforti	v.tr	
stronger	pli forta	adj.	
fainter	pli malforta	adj.	
]

_help_ = [
help	helpi	v.tr	
aid	helpi	v.tr	
prevent	malhelpi	v.tr	
helpless	senhelpa	adj.	w
aid	helpo	n.	w
couldn’t help yourself	ne povis sin malhelpi	phr.	
]

_neĝ_ = [
snow	neĝo	n.	w
snow on the ground	neĝo sur la tero	phr.	
snowdrifts	neĝamasoj	n.	
snows	neĝoj	n.	
snowy	neĝa	adj.	w
]

_nom_ = [
name	nomi	v.tr	w
name	nomo	n.	w
name	nomumi	v.tr to appoint eg to a post	w
nameless	nenomita	adj.	w
call	nomi	v.tr to refer eg 'you call that a knife?'	
nameless	sennoma	adj.	w
nameless thing	sennomaĵo	n.	
appoint	nomumi	v.tr to appoint (to a post)	w
on behalf of	nome de	phr.	w
first name	antaŭnomo	n. personal name or given name	
love-name	karesnomo	n.	s
pet name	karesnomo	n.	w
that is to say	nome	phr.	s
]

_dorm_ = [
sleep	dormi	v.ntr	w
asleep	dormanta	adj.	w
insomnia	sendormeco	n.	w
sleeplessness	sendormado	n.	w
]

_vast_ = [
vast	vasta	adj.	w
close	malvasta	adj. small, and confining	
cramped	malvasta	adj.	w
poky	malvasta	adj.	w
spread	vastiĝi	v.ntr	w
widespread	disvastigita	adj.	
]

_kresk_ = [
grow	kreski	v.ntr to grow, increase or become bigger	
grow	kreskigi	v.tr make something grow	
grows	kreskas	v.ntr	
grew	kreskis	v.ntr	
growing	kreskante	adv.	
wane	malkreski	v.ntr	w
decreasing	malkreskanta	adj.	
waning	malkreskanta	adj. eg waning moon	
waxing	kreskanta	adj. eg the waxing moon	
rank	trokreskanta	adj. overgrowing	
rank	trokreskinta	adj. overgrown (archaic)	w
overgrown	superkreskita	adj.	
grownup	plenkreskulo	n.	w
adult	plenkreskulo	n.	w
grown-up	plenkreskulo	n.	w
]

_plen_ = [
teem	pleni	v.ntr	w
full	plena	adj.	
fulfil	plenumi	v.tr	
void	malpleno	n.	
filled	plenigita	adj.	w
perform	plenumi	v.tr fulfill	
crowded	plena	adj.	w
fill	plenigi	v.tr make full	
crowded	homplena	adj. full of people	
empty	malplena	adj.	
have fulfilled	plenumis	v.tr	
filled with	plenigita de	phr.	
fraught with	plena je	phr.	
]

_liber_ = [
free	libera	adj.	w
freedom	libereco	n.	w
freely	libere	adv.	w
confine	malliberigi	v.tr imprison	w
liberty	libereco	n.	w
deliver	liberigi	v.tr make free 	w
jail-like	mallibereca	adj.	w
jail-like	malliberejo-simila	adj.	w
]

_frenez_ = [
frenzied	freneza	adj.	w
frantic	freneza	adj. crazy	
madness	frenezo	n.	
crazy	freneza	adj.	
raving mad	frenezi	v.ntr	
be crazy	frenezi	v.ntr	
maddening	freneziga	adj.	w
madly	freneze	adv.	w
]

_oft_ = [
common	ofta	adj. frequently occurring	w
often	ofte	adv.	w
rare	malofta	adj.	
rarely	malofte	adv.	
most of the time	plejofte	adv.	w
]

_ating_ = [
achieve	atingi	v.tr	w
reach	atingi	v.tr	
reach	atingo	n.	
overtake	atingi	v.tr catch up to	w
overtaking	atingante	adv.	
topped	atingis la supron	phr. reached the top	
outreaching	preteratinganta	adj. reaching beyond	
make for	penu atingi	phr. move toward, attempt to reach	w
]

_grand_ = [
big	granda	adj.	w
great	granda	adj. large	
large	granda	adj.	
massive	granda	adj. large	w
greater	pli granda	phr.	
larger	pli granda	adj.	
bigger	pli granda	phr.	
slight	malgranda	adj. not large	
little	malgranda	adj.	
small	malgranda	adj.
biggest	plej granda	adj.	
greatest	plej granda	adj.	
immense	grandega	adj.	w
massive	grandega	adj. very large	w
utmost	plej granda	adj.	w
magnitude	grandeco	n.	w
size	grandeco	n.	w
enormous	grandega	adj.	
terrific	grandega	adj. very large	
expand	pligrandiĝi	v.ntr get bigger	w
shrink	malgrandiĝi	v.ntr get smaller	
bigwig	grandulo	n.	w
as greatly	same grande	adv.	
Great One	Grandulo	phr. moniker	
had little enough	havis malgrande sufiĉe	adv.	
]

_grandioz_ = [
splendid	grandioza	adj.	w
magnificent	grandioza	adj.	w
magnificence	grandiozeco	n.	w
]

_cert_ = [
certain	certa	adj. (+ noun) something definite, eg a certain thing	w
uncertain	necerta	adj.	
assuredly	certe	adv.	w
certain	certa	adj. not having doubt, or something definite	
certainly	certe	adv.	
surely	certe	adv.	w
am sure	certas	v.ntr	
to make sure	certiĝi	v.ntr	w
assure	certigi	v.tr	w
are you sure	ĉu vi certas	phr.	s
]

_imit_ = [
imitate	imiti	v.tr	w
imitative	imita	adj.	w
imitation	imito	n. act of imitating	w
imitation	imitado	n. act of imitating	w
imitator	imitanto	n.	w
mimic	imitisto	n. professional imitator 	
inimitable	neimitebla	adj.	w
unimitable	senimita	adj.	w
onomatopeo	sonimito	n. 	w
]

_taŭg_ = [
be of use	taŭgi	v.ntr	
suit	taŭgi	v.ntr be suitable for	w
be serviceable	taŭgi	v.ntr	
be valuable	taŭgi	v.ntr for something	
fit	taŭga	adj. suitable	
fit	taŭgi	v.ntr be suitable	
suitable	taŭga	adj.	w
valuable	taŭga	adj. for something	
]

_bat_ = [
blow	bato	n. hit or strike	w
beating	batado	n.	w
]

_batal_ = [
fight	batali	v.ntr	w
fought	batalis	v.ntr	
fight	batalo	n. 	w
battling	batalanta	adj.	
]

_ŝirm_ = [
guard	ŝirmi	v.tr	w
protect	ŝirmi	v.tr	w
screened	ŝirmis	v.tr shield eg from view	w
shield	ŝirmi	v.tr	w
shelter	ŝirmo	n.	w
]

# -VIV-
_viv_ = [
are alive	vivas	v.ntr	
vivid	viva	adj.	w
endure	travivi	v.tr	
survivor	supervivinto	n.	w
living	vivado	n.	w
life	la vivo	n.	
alive	viva	adj.	w
vividly	vive	adv.	
been through	travivis	v.tr	w
life	vivo	n.	w
makes live	vivigi	v.tr	w
living	vivanta	adj.	w
course of life	kursado de vivo	n.	s
outlive	postvivi	v.tr	w
]

_sol_ = [
alone	sola	adj.	w
lone	sola	adj.	
loneliness	soleco	n.	w
lonely	soleca	adj.	w
alone	sole	adv. 	
]

_far_ = [
do	fari	v.tr	
make	fari	v.tr	
made	farigis	v.tr	
made	farita	adj.	
undo	malfari	v.tr	w
will do	faros	v.tr	
won’t	ne faros	phr.	
deed	faro	n.	w
fashioned	farita	adj. made	
shall	faros	v.tr	
done	faris	v.tr	w
artificial	artefarita	adj.	w
don’t	ne faru	phr. imperative 'don't do it'	
I’ve done	mi faris	phr.	
does	faras	v.tr	
doesn’t	ne faros	phr.	
by	fare de	phr. made by	
you shall	vi faru	phr.	
wouldn’t	ne farus	phr.	
well-fashioned	bone farita	adj.	
might do	eble farus	v.tr	s
get	fariĝi	v.ntr become	w
I’ll do it	mi faros ĝin	phr.	s
]

_glat_ = [
smooth	glata	adj.	
smoothly	glate	adv.	
ragged	malglata	adj.	w
rough	malglata	adj.	w
]

_montr_ = [
show	montri	v.tr	
shewed	montriĝis	v.ntr made oneself visible to the eyes	
shows	montriĝas	v.ntr	
being shown	montrata	adj.	
demonstrate	montri	v.tr by illustration	
showing	montranta	adj.	
points	almontras	v.tr	W
displayed	montrita	adj.	
shown	montrita	adj.	
portraying	montranta	adj.	
represented	montra	adj. portrayed in a drawing	
hands	montriloj	n. hands of a clock	w
pointing	fingromontrante	adv.	
]

_flug_ = [
fly	flugi	v.ntr	
flies	flugas	v.ntr	
flown	flugis	v.ntr	
flying	fluginta	adj.	
flew back	reflugis	v.ntr	
flier	fluganto	n.	w
in-flight	fluganta	adj.	
]

_trankvil_ = [
calmly	trankvile	adv.	w
don’t worry	restu trankvila	adj.	
calm yourself	trankviliĝu	v.ntr	w
calm	trankvila	adj.	w
relief	ektrankviliĝo	n. experience of being relieved of stress	w
troubled	maltrankvila	adj. anxious	w
disquieting	maltrankviliga	adj. making one worried	
uneasiness	maltrankvilo	n.	
worry	maltrankviligi	v.tr	
worried	maltrankvila	adj.	w
uneasiness	maltrankvileco	n.	w
anxiety	maltrankvileco	n. mild anxiety, level-1	w
anxiously	maltrankvile	adv.	w
]

_aŭdac_ = [
dare	aŭdaci	v.tr	w
daringly	aŭdace	adv.	w
boldly	aŭdace	adv.	
audacity	aŭdaco	n.	w
]

_plaŭd_ = [
plopped	plaŭdis	v.ntr	w
lapping	plaŭdado	n. of water	w
lapping	plaŭdanta	adj.	
]

# -AŬD-
_aŭd_ = [
hear	aŭdi	v.tr	
heard	aŭdis	v.tr	
hears	aŭdas	v.tr	
heard	aŭdata	adj.	
heard	aŭdiĝas	v.ntr is heard	
audible	aŭdebla	adj.	w
audient	aŭdanta	adj. hearing	
receiver	aŭdilo	n.	w
unheard-of	neaŭdita	adj.	w
overhear	kaŝe aŭdi	phr.	w
overhear	hazarde aŭdi	phr. accidentally overhear	w
]

_dev_ = [
have to	devi	v.ntr	
must	devi	v.ntr	
must	devas	v.ntr (+inf)	
must not	devi ne	phr.	
ought to	devus	v.ntr (+inf)	w
must	devus	v.ntr must, ie should	
compel	devigi	v.tr	w
driven	devigita	adj. compelled	w
should	devus	v.ntr	
made	devigis	v.tr compelled	
forcibly	devigante	adv.	w
need not	ne devi	phr.	
mustn’t	ne devas	phr.	
must	nepre devas	phr. absolutely must	

]

_vigl_ = [
crisp	vigla	adj.	
brisk	vigla	adj.	w
attentive	vigla	adj.	
vivid	vigla	adj.	w
alert	vigla	adj.	w
vigorous	vigla	adj.	w
smart	vigla	adj.	
hard	vigle	adv. vigorously	w
]

_perd_ = [
lose	perdi	v.tr	w
lost	perdis	v.tr	
were lost	perdiĝis	v.ntr became lost	
]

# -LOĜ-
_loĝ_ = [
dwell	loĝi	v.tr ARCHTECTURE	
inhabited	loĝis	v.tr.ntr (+ en)	w
dwelt	loĝis	v.tr.ntr	w
habitation	loĝejo	n. a place where one lives, inc animals	w
dwelling	loĝejo	n.	w
house	loĝigi	v.tr provide accomodation	w
dweller	loĝanto	n. ARCHTECTURE	
settle	enloĝiĝi	v.ntr move in	w
]

_romp_ = [
break	rompiĝi	v.ntr become broken, separate oneself into parts like a word into syllables	
broke forth	elrompiĝis	v.ntr	
broken	rompita	adj.	
crisp	facilrompa	adj.	w
fragile	facilrompa	adj.	
interrupt	interrompi	v.tr	
have broken	rompis	v.tr	
should break	rompiĝus	v.ntr would hypothetically break	
breaking	rompiĝo	n. breakage	
break away	forrompiĝi	v.ntr	w
break through	trarompi	v.tr	w
broke through	trarompis	v.tr	w
snap	rompiĝi	v.ntr	w
brokenly	rompite	adv.	w
might break	eble rompiĝus	phr.	
]

_bel_ = [
beautiful	bela	adj.	
handsome	bela	adj.	w
fair	bela	adj.	w
pretty	bela	adj.	w
unsightliness	malbeleco	n.	w
beauty	beleco	n.	w
splendour	belegeco	n.	w
gorgeous	belega	adj.	w
splendor	belegeco	n.	w
gorgeously	belege	adv.	w
ugly	malbela	adj.	w
loveliness	beleco	n.	w
loveliest	plej bela	adj.	w
consuming beauty	konsumema beleco	n.	s
]

# -ATENT-
_atent_ = [
be careful	atenti	v.tr pay attention	
attention	atento	n.	w
attentive	atenta	adj.	w
attentive	atentema	adj.	w
care	atento	n. being meticulous	
careful	atenta	adj. attentive	
carelessly	senatente	adv.	
call attention to	atentigi	v.tr	
caution	atentigi	v.tr to warn	w
draw attention to	atentigi	v.tr	
remark	atentigi	v.tr	
ignore	malatenti	v.tr	w
inattentive	malatenta	adj.	
overlook	preteratenti	v.tr	w
pay attention to	atenti	v.tr	
pay attention to	priatenti	v.tr	
intently	atente	adv.	
closely	atente	adv. attentively	
heed	atenti	v.tr	w
]

_honor_ = [
honour	honori	v.tr show respect	
honour	honoro	n.	
honored	honorita	adj.	w
dishonour	malhonoro	n.
]

_ŝtup_ = [
step	ŝtupo	n. step of a staircase	
ladder	ŝtupetaro	n.	w
staircase	ŝtuparo	n.	w
stairwell	ŝtuparejo	n.	w
flight of steps	ŝtuparo	n.	w
stairs	ŝtuparo	n.	
]

_port_ = [
wore	portis	v.tr CLOTHES	w
bore	portis	v.tr carried as a burden	
bring	alporti	v.tr	w
bring in	enporti	v.tr	w
carried	portis	v.tr	
carried out	forportata	phr.	
carries	portas	v.tr	
porter	portisto	n.	
taking	elportonta	adj. was fixing to take	
has brought	alportis	v.tr	
shall bring	alportos	v.tr	
carried with	kunportis	v.tr	
have been carrying	estis portanta	phr.	
portable	portebla	adj.	w
brought	alportis	v.tr	
carrying	kunportante	adv.	
worn	portata	adj.
panoplied	panoplio-portanta	adj.	w
]

_pord_ = [
doorway	pordejo	n.	w
gate	pordego	n.	w
portal	pordego	n.	w
door	pordo	n.	w
above the door	superporde	adv.	
]

_konduk_ = [
conduct	konduki	v.tr an orchestra	w
introduction	enkonduko	n.	
lead	konduki	v.tr	
led	kondukis	v.tr	
led off	forkondukis	v.tr	
chauffeur	konduki aŭtomobile	phr. take someone somewhere by car	
was about to lead	estis kondukonta	phr.	
lead back	rekonduki	v.tr
]

_disting_ = [
tell	distingi	v.tr distinguish	w
distinguish	distingi	v.tr	
differentiated	distingis	v.tr	
discernible	distingebla	adj.	
marked	distingiĝa	adj. distinguishing	
]

_dekstr_ = [
left-hand	maldekstra	adj.	w
right	dekstra	adj.	
right	dekstre	adv.	
to the right	dekstren	adv.	w
left	maldekstra	adj.	w
left	maldekstre	adv.	
to the left	maldekstren	adv. as a destination	
]

_fund_ = [
profound	profunda	adj.	
profoundly	profunde	adv.	w
underside	fundo	n.	
innermost part	fundo	n.	
inner	profunda	adj.	w
base	fundo	n.	
bottom	fundo	n.	
deep	profunde	adv. deeply	
deepen	profundigi	v.tr	
deepest	plej profunda	adj.	
deeply	profunde	adv.	
depth	profundo	n. the deep part or the depth of a place	w
]

_kutim_ = [
accustomed	kutimi	v.tr.ntr (+ inf.; al aŭ tr) to be accustomed to	
grew more accustomed to	pli alkutimiĝis	phr.	
unusual	nekutima	adj.	w
usual	kutima	adj.	w
usually	kutime	adv.	w
wean	dekutimigi	v.tr	w
as usual	kiel kutime	phr.	w
uncommonly	nekutime	adv.	W
custom	kutimo	n.	w
is used to	kutimas	v.ntr is accustomed to	w
unaccustomed	nekutima	adj.w
]

_tut_ = [
absolutely	tute	adv.	w
all	tuta	adj.	
all over	tute tra	phr.	
completely	tute	adv.	
entire	tuta	adj.	w
entirely	tute	adv.	w
whole	tutaĵo	n.	W
all the	la tuta	phr.	
wholly	tute	adv.	w
quite	tute	adv. completely	w
whole	tuta	adj.	
total	tutaĵo	n.	
utterly	tute	adv.	
]

_atend_ = [
wait for	atendi	v.tr	
await	atendi	v.tr	
expect	atendi	v.tr	
expected	estus atendinta	phr. would have been expecting	
are expecting	atendas	v.tr	
waiting	atendinta	adj. condition of having waited	
wait	atendi	v.tr	w
unexpected	neatendita	adj.	w
]

_varm_ = [
chilly	malvarma	adj. HEAT	w
chill	malvarmeto	n.	w
cold	malvarma	adj.	w
colder	pli malvarma	adj.	s
cool	malvarma	adj. not hot	w
cooling	malvarmiĝanta	adj.	
coolly	malvarme	adv.	w
warmth	varmeco	n.	w
hot	varma	adj.	w
heat	varmeco	n. warmth	w
warm	varma	adj.	w
coldly	malvarme	adv.	w
]

_trem_ = [
tremble	tremi	v.ntr	w
quiver	tremi	v.ntr	w
shaking	tremanta	adj.	
shiver	tremigi	v.tr make one shiver	
shuddered	ektremis	v.ntr	
quivering	tremanta	adj.	
shaky	tremanta	adj.	w
shudderingly	ektremante	adv.	w
chill	malvarm'tremo	n. sensation of a chill accompanied by trembling	
make tremble	tremigi	v.tr	s
]

_gras_ = [
fat	graso	n.	
oil	graso	n.	
greasy	grasa	adj.	w
emaciated	malgrasega	adj.	w
lard	porkograso	n.	w
]

_komenc_ = [
commence	komenci	v.tr	
begin	komenci	v.tr	
begins	komenciĝas	v.ntr	
fell to	komencis	v.tr began	w
makes to	komenciĝas	v.ntr begins to begin to	
dawn	komenco	n. figurative 'beginning'	
at first	komence	adv.	w
began	komencis	v.tr	
begin again	rekomenci	v.tr resume	
beginning	komenco	n.	
first	komenca	adj. initial, at the beginning	
resume	rekomenci	v.tr	
is begun	komencitas	v.tr	
take it up again	rekomenci ĝin	phr.	
]

_minac_ = [
threaten	minaci	v.tr	w
threat	minaco	n.	w
sinister	minaca	adj. threatening	w
threateningly	minace	adv.	w
]

_puŝ_ = [
push	puŝi	v.tr	
nudge	puŝeti	v.tr	
thrust	puŝi	v.tr	w
pushing him off	elpuŝante lin	phr.	
repellent	forpuŝema	adj.	w
gust	ventopuŝo	n. WEATHER	w
]

_kovr_ = [
cover	kovri	v.tr	w
uncover	malkovri	v.tr	
coverlet	kovrilo	n. blanket used for a bed	w
discover	malkovri	v.tr	
discovery	malkovro	n.	w
lined with	kovrita per	phr.	w
]

_rest_ = [
rest	resto	n. remainder	w
remain	resti	v.ntr	
stay	resti	v.ntr	
abide	restadi	v.ntr	w
]

_vol_ = [
be willing	voli	v.tr	
choose	voli	v.tr	
like	volas	v.tr want	w
will	volo	n. desire or intention	
want	voli	v.tr	
don't wish	ne volas	v.tr	
wish	volo	n. will	w
involuntary	nevola	adj.	
reluctant	malvolonta	adj.	w
have a mind to	voli	v.tr	
pray	bonvolu	v.tr archaic 'please'	w
please	bonvolu	v.tr please	w
goodwill	bonvolo	n.	w
wonder	scivoli	v.tr mentally	
curious	scivola	adj.	w
curious	scivolema	adj.	w
wanting to know	scivola	adj.	
curiosity	scivoleco	n. desire to know	
curiosity	scivolemo	n. constant desire to know	
curiously	scivole	adv.	w
self-will	memvolo	n.	w
]

_ruz_ = [
cunning	ruza	adj.	
trick	ruzo	n.	w
trickster	ruzulo	n.	w
cunningly	ruze	adv.	w
slyly	ruze	adv.	w
]

# -VER-
_ver_ = [
truth	vero	n.	w
true	vera	adj.	w
actual	vera	adj. true	w
genuine	vera	adj.	w
genuinely	vere	adv. truthfully, in a real way, admittedly	w
truly	vere	adv.	w
really	vere	adv. true, not false	w
indeed	vere	adv. truly	w
truthfully	vere	adv.	W
in truth	vere	adv.	w
in sooth	vere ja	phr. truthfully	w
very	vera	adj. figurative 'true'	w
it is true	estas vere	phr.	
is it true?	ĉu vere?	phr.	s
truest	plej vera	adj.	s
realistic	vivovera	adj. true to life ART	w
]

# -RIGARD-
_rigard_ = [
gaze	rigardi	v.tr	w
look	rigardi	v.tr to look at with the eyes	
watching	rigardi	v.tr	
watched	rigardas	v.tr	
beheld	rigardis	v.tr	
leer	rigardaĉi	v.tr	w
beholding	rigardante	adv.	w
glaring	kolerrigardanta	adj.	w
stare	fikse rigardi	v.tr	w
look out	elrigardi	v.tr	w
see	rigardi	v.tr eg iros rigardi: 'go look'	
looking	rigardante	adv.	
gazing	rigardante	adv.	
look on	rigardas	v.tr	w
looking back	retrorigardante	adv.	w
peering	esplorrigardante	adv.	
peering	rigardante	adv.	
peering	rigardegi	v.tr	
glance	ekrigardi	v.tr	w
stares hard	fikse rigardas forte	phr.	
have been watching	estis rigardanta	phr.	
peer	elrigardi	v.tr	w
look away	forrigardi	v.ntr	w
looks after	pririgardas	v.tr	w
watching	rigardante	adv.	
peep in	enrigardi	v.tr	w
staring	rigardante fikse	adv.	w
look through	trarigardi	v.tr	W
eye	rigardo	n. fig. gaze	
glance	ĵeta rigardo	n.	
view	rigardo	n.	
survey	superrigardo	n. overview	
look into	enrigardi	v.tr	w
]

_gard_ = [
guard	gardi	v.tr	
be careful	singardi	v.ntr	
bodyguard	korpogardisto	n.	
careful	singarda	adj.	
carefully	singarde	adv.	
cautious	singarda	adj. lit. self-guarding	
cautiously	singarde	adv.	
warily	singarde	adv.
keeping	gardado	n. custody	w
bodyguard	korpogardistaro	n. group of bodyguards	w
]

_klin_ = [
lean	klini	v.tr	
bow	kliniĝi	v.ntr	
leaned over	klinis sin	phr.	
bending	kliniĝanta	adj.	
dipping	kliniĝanta	adj. leaning over	
stooped	kliniĝis	v.ntr	
stoops	kliniĝas	v.ntr	
tip	suprenklini	v.tr tip upward	
]

_turn_ = [
turn	turni	v.tr	
turn	turniĝi	v.ntr	
was whirling	turniĝadis	v.ntr	w
turn to	sin turni	phr.	
avert	forturni	v.tr	
back again	returne	adv.	
dizzy	kapturna	adj. causing vertigo	
turning back	returniĝi	v.ntr	w
direct away	forturni	v.tr	
revolving	turniĝanta	adj.	
spin	turni sin	phr. period of dancing	
]

_parol_ = [
talk	paroli	v.tr	w
speak	paroli	v.ntr	
spoke	parolis	v.tr.ntr	
spake	parolis	v.tr.ntr	
to say nothing of	sen paroli pri	phr.	
discuss	interparoli	v.ntr to converse	
address	alparoli	v.tr	w
verbal	parola	adj.	w
speech	parolado	n.	
speech	parolo	n. capacity or action	
speechless	senparole	adv.	
you’ve talked	vi parolis	phr.	
talk	parolado	n.	
speaker	parolanto	n.	w
spokesman	proparolanto	n.
talk together	interparoli	v.ntr	
]

# -LAŬT-
_laŭt_ = [
loud	laŭta	adj.	
louder	pli laŭte	adv.	
loudest	plej laŭta	adj.	w
lower	pli mallaute	adv.	
loudly	laŭte	adv.	
aloud	laŭte	adv.	
volume	laŭteco	n. loudness of sound	w
softly	mallaŭte	adv.	w
rose	plilaŭtiĝis	v.ntr increased in sound volume	
low	mallaŭta	adj. not loud	w
lowering	mallaŭtigante	adv. making quieter	
]

# -AM-
_am_ = [
love	amo	n.	
love	ami	v.tr	
hate	malami	v.tr	w
hated	malamita	adj. unloved	w
hateful	malaminda	adj. deserving to be hated	w
has loved	amis	v.tr	
loving	amanta	adj.	
in love	enamiĝinte	adv.	
beloved	amata	adj.	w
best loved	plej amata	adj.	
favorite	plej amata	adj. best loved	
lover	amanto	n.	
fondly	ame	adv.	
love me too well	amas min tro profunde	phr.'love me too deeply'	
]

_amor_ = [
love	amoro	n. sexual love, love affair, sexual activity	
make love	amori	v.tr.ntr	
]

# -MORT-
_mort_ = [
becoming extinct	formortas	v.ntr	
dead	morta	adj.	
dead	mortinta	adj.	
dead	mortintoj	n. those who have died	w
death	morto	n.	w
die	morti	v.ntr	w
should die	mortus	v.ntr	
died away	formortis	v.ntr	w
fatal	mortiga	adj.	w
kill	mortigi	v.tr	w
lethal	mortiga	adj.	w
dying	mortante	adv.	w
dance of death	mortodanco	phr. medieval painting theme	w
mortuary	mortejo	n. death place in an abstract sense	
death-like	kvazaŭ-morta	adj. 	w
death-hating	morton-malŝateganta	adj. 	
eon-dead	eone mortinta	adj. 	
died out	formortis	v.ntr	
immortality	senmorteco	n.	w
deathless	senmorta	adj.	w
]

_glor_ = [
glory	gloro	n.	
gloriously	glore	adv.	w
glorious	glora	adj.	w
]

_bon_ = [
good	bona	adj.	w
well	bone	adv.	
fine	bona	adj.	
all right	bone	adv.	w
amiss	malbone	adv.	w
worse	pli malbona	adj.	
evil	malbono	n.	w
awful	malbonega	adj. very bad	w
best	plej bone	adv.	
better	pli bone	adv.	
excellent	bonega	adj.	w
improved	plibonigita	adj.	
fantastic	bonega	adj. very good	
boon	bono	n. that which is good	w
bad	malbona	adj.	w
greatest	plej bona	phr.	
more than good	ege bona	adj.	
great	bonega	adj.	
harm	malbono	n. moral badness	
]

# -KOMPR-
_kompren_ = [
understanding	kompreno	n.	w
understand	kompreni	v.tr	w
understanding	komprenante	adv.	
comprehension	kompreno	n.	w
make me understand	komprenigi min	phr.	
understands	komprenas	v.tr	
realising	komprenante	adv.	
realising	ekkomprenante	adv.	
of course	kompreneble	adv.	w
understood	komprenis	v.tr	
realize	ekkompreni	v.tr	w
]

_komand_ = [
command	komandi	v.tr	
control	komandi	v.tr	
bidding	komandadite de	phr. at one's bidding	
bids	komandas	v.tr	w
]

_kurag_ = [
brave	kuraĝa	adj.	
courage	kuraĝo	n.	
heartened	kuraĝigis	v.tr gave one courage and vitality	
plucky	kuraĝa	adj.	
bravest	plej kuraĝa	adj.	
coward	malkuraĝulo	n.	w
venture	kuraĝi	v.ntr(+inf) dare to do something 	w
]

_sort_ = [
destiny	sorto	n.	
fate	sorto	n.	w
lot	sorto	n. lot in life, as in fate	w
luck	sorto	n.	
Fates	Sortoj	n.proper myth Atropos, Clotho, and Lachesis	w
]

_akcept_ = [
reception	akcepto	n. act of receiving	w
snub	malakcepto	n.	w
accepted	akceptata	adj.	
accept	akcepti	v.tr	w
]

_kuŝ_ = [
fall	kuŝiĝi	v.ntr a thing to fall flat like a cut tree	
lay	kuŝigi	v.tr lay something down, make it lie	
lie	kuŝi	v.ntr be resting horizontal, have horizontal sex, occupy a space eg 'lies to the East'	
lies	kuŝas	v.ntr	
lie	kuŝiĝi	v.ntr to lie oneself down, become and become recumbent	
recumbent	kuŝa	adj.	w
lies	kuŝiĝas	v.ntr to become lying down	w
lying	kuŝanta	adj.	
were laid	kuŝigis	v.tr	w
lay	kuŝi	v.ntr to occupy a space	
dark-lying	mallume kuŝanta	adj.	
]

# -SCI-
_sci_ = [
be aware of	scii	v.tr know a fact	
know	scii	v.tr know a fact	
knows	scias	v.tr	
know not	scias-ne	phr.	
knew	sciis	v.tr	
knowledge	scio	n. all that is known	
as you know	kiel vi scias	phr.	
come to know	ekscii	v.tr	
didn’t know	ne sciis	phr.	
find out about	ekscii	v.tr	
ken	scio	n.	w
knowledge	sciaĵo	n.	
ignorant	senscia	adj. unknowing	w
shall know how to	scipovos	v.tr	
came to learn	eksciis	v.tr found out	
completely at a loss to	tute ne scias kiel	phr.	w
]

## -FOJ- 
_foj_ = [
occasionally	foje	adv.	w
occasion	fojo	n.	w
on occasions	foje	adv.	
for the first time	unuafoje	adv.	
once	foje	adv.	
once	unufoje	adv. on one occasion	w
once or twice	unu-dufoje	phr.	
a second time	duafoje	adv.	w
time	fojo	n. occasion	
sometimes	kelkfoje	adv.	
for once	por unufoje	phr.	w
several times	plurfoje	adv.	
this time	ĉi-foje	adv.	w
]

_valor_ = [
worth	valoro	n.	w
worthless	senvalora	adj.	w
precious	altvalora	adj.	w
]

_inform_ = [
inform	informi	v.tr	w
learn about	informiĝi	v.ntr	
become informed about	informiĝi	v.ntr	
check out	informiĝi	v.ntr	
]

_edz_ = [
husband	edzo	n.	
wife	edzino	n.	
wives	edzinoj	n.	
proposed	proponis geedziĝon	phr. proposed marriage	
marriage	geedziĝo	n.	
get married	edziĝi	v.ntr become a husband	
get married	edziniĝi	v.ntr become a wife	
marry	edziniĝi	v.ntr become a wife	
get married	geedziĝi	v.ntr become a married couple, heterosexual	
bride	novedzino	n.	
just going to be married	jus geedziĝonta	adj.	
wedding	geedziĝo	n.	
]

_flustr_ = [
whisper	flustro	n.	w
whisper	flustri	v.tr	
is whispering	flustras	v.tr	w
whispering	flustranta	adj.	
whispering	flustrante	adv.	
]

_dub_ = [
doubt	dubo	n.	
doubted	dubis	v.tr	
doubtless	sendube	adv.	
no doubt	sendube	adv.	w
question	pridubi	v.tr doubt	
unmistakable	senduba	adj.	
]

# -KVIET-
_kviet_ = [
quiet	kviete	adv.	
quietly	kviete	adv.	w
unquiet	malkvieta	adj. 	
quietness	kvieteco	n. 	w
]

_vic_ = [
column	vico	n.	
line	vico	n. queue	w
one’s turn	vico	n. ie place in line	
place in line	vico	n.	
queue	vico	n.	w
row	vico	n.	w
string	vico	n. group of things arranged in a row or col	w
in turn	laŭvice	adv.	w
]

_star_ = [
stand	stari	v.ntr to be standing	
stood out	elstaris	v.ntr	
stood	staris	v.ntr	
oppose	kontraŭstari	v.tr	w
standing	staranta	adj.	w
are prominent	elstaras	v.ntr	
stand against	kontraŭstari	v.tr oppose	w
loom	superstari	v.tr to tower, to have ones top above somthing	w
erect	starigi	v.tr to cause to stand up or be built	w
stood up	stariĝis	v.ntr	w
stand up	stariĝi	v.ntr	w
]

# -FID-
_fid_ = [
confident	fida	adj.	w
trust	fidi	v.tr	w
confidently	memfide	adv.	
]

_perfid_ = [
betray	perfidi	v.tr	w
fail	perfidi	v.tr moral failure or letting someone down
treachery	perfido	n.	w
]

_fidel_ = [
faithful	fidela	adj.	w
true	fidela	adj. faithful	w
]

_balai_ = [
mop	balai	v.tr	
broom	balailo	n.	w
sweep	balai	v.tr	w
swept	balais	v.tr	
clean-up	balao	n. a clean-up	
]

_sever_ = [
rigorous	severa	adj.	w
severe	severa	adj.	w
stern	severa	adj.	w
strict	severa	adj.	w
severity	severeco	n.	w
]


_ĉes_ = [
cease	ĉesi	v.ntr cease doing something	
ceaseless	senĉesa	adj.	
discontinue	ĉesigi	v.tr to discontinue something	
ceased	ĉesinta	adj.	
stop	ĉesi	v.ntr cease	
stop	ĉesigi	v.tr	w
stopped	ĉesigis	v.tr made it stop	
left it off	ĉesis	v.ntr	w
incessantly	senĉese	adv.	
inexorably	senĉese	adv.	w
cut it out	ĉesu	v.ntr 	w
]

_met_ = [
put	meti	v.tr	
lay	meti	v.tr	w
sets	metas	v.tr puts	w
set	metis	v.tr put, past tense	
put aside	formeti	v.tr	
deference	submetiĝo	n.	w
submission	submetiĝo	n.	w
laid it down	demetis ĝin	phr.	w
folded	kunmetita	adj. compound, in the sense of folded hands	
lay upon	surmeti	v.tr	
put back	remeti	v.tr	
has put aside	formetis	v.tr	w
interfere	sin intermeti	v.tr	w
placed upon me	metita sur min	phr.	
]

# -AKR- 
_akr_ = [
keen	akra	adj.	
sharp	akra	adj.	
keenly	akre	adv.	w
sharply	akre	adv.	w
dull	malakrigi	v.tr make not sharp	w
acute	akra	adj.	w
keenest	plej akra	adj.	
]

_sakr_ = [
swear	sakri	v.ntr cuss	
cursed	sakris	v.ntr	w
swore	sakris	v.ntr used profanity	
cuss	sakri	v.ntr	w
]

_sugest_ = [
suggest	sugestas	v.tr	
suggestively	sugeste	adv.	w
suggesting	sugestanta	adj.	
]

_kri_ = [
cry	krii	v.tr.ntr	
shout	krii	v.tr.ntr	
cried	kriis	v.tr.ntr	
screamingly	kriege	adv.	
screams	kriegoj	n.	
yell	kriego	n.	w
exclamation	ekkrio	n.	
screaming	kriegante	adv.	
]

# -DAUR- 
_daŭr_ = [
last	daŭri	v.ntr endure	
endure	daŭri	v.ntr	
continue	daŭri	v.ntr	
continue	daŭrigi	v.tr	
lingered	daŭris	v.ntr continued	
went on	daŭre	adv.	
maintain	daŭrigi	v.tr	
enduring	daŭrema	adj.	w
]

_bedaŭr_ = [
remorse	bedaŭro	n.	w
regret	bedaŭri	v.tr	w
sorry	bedaŭri	v.tr am sorry, express regret	w
unfortunately	bedaŭrinde	adv.	w
without regret	senbedaŭre	adv.	
I'm sorry	mi bedaŭras	phr.	w
]

_horor_ = [
horror	hororo	n. feeling of terror with disgust	w
horrible	horora	adj. causing horror	w
horrible	horora	adj.	w
horribly	horore	adv.	w
]

_pend_ = [
hangs	pendas	v.ntr	w
depend	dependi	v.ntr	
hung	pendis	v.ntr	w
hung	pendigis	v.tr	
]

_inic_ = [
indoctrinate	inici	v.tr into a society	
initiate	inici	v.tr into a society	
initiate	iniciati	v.tr be the first to do	
]

_just_ = [
just	justa	adj.	w
justice	justeco	n.	w
fair	justa	adj.	w
just-ness	justeco	n.	w
]

_fart_ = [
fare	farti	v.tr	w
feel	fartas	v.ntr	
get on	farti	v.tr	
get along	bonfarti	v.ntr	w
]

_promen_ = [
go for a stroll	promeni	v.ntr incl in a boat, bike, car, by foot, etc	
go for an outing	promeni	v.ntr incl in a boat, bike, car, by foot, etc	
stroll	promeni	v.ntr	w
take a walk	promeni	v.ntr	w
walk	promeno	n.	
]

_ŝerc_ = [
witticism	ŝerco	n.	w
teasing	ŝerce	adv. jokingly	
joke	ŝerco	n.	
jocular	ŝercema	adj.	w
practical joke	ŝerco	n.	
]

# -ĜEN-

_ĝen_ = [
disturb	ĝeni	v.tr	
hamper	ĝeni	v.tr	w
inconvenience	ĝeni	v.tr	w
trouble	ĝeno	n. nuisance or disturbance	
trouble	ĝeni	v.tr	
troubled	ĝenita	adj.	w
troubled	ĝenita	adj.	w
be shy	sin ĝeni	v.tr	
bother	ĝeni	v.tr	w
]

_ĝent_ = [
genteel	ĝentila	adj.	w
polite	ĝentila	adj.	w
politeness	ĝentileco	n.	
rude	malĝentila	adj.	w
nice	ĝentila	adj. polite	w
]

###################

_viŝ_ = [
wipe	viŝi	v.tr clean by rubbing	
wipe	deviŝi	v.tr remove by wiping	
wipe	forviŝi	v.tr erase by wiping	
]

_saĝ_ = [
wisdom	saĝo	n.	w
fool	malsaĝulo	n.	
foolish	malsaĝa	adj.	
foolishly	malsaĝe	adv.	
message	mesaĝo	n.	w
wise	saĝa	adj.	
wise men	saĝuloj	n.	
messenger	mesaĝisto	n.	w
wisest	plej saĝa	phr.	
]

_amik_ = [
friend	amiko	n.	
pal	amiko	n.	
friendship	amikeco	n.	w
enemy	malamiko	n.	w
]

# -KRED-
_kredi_ = [
believe	kredi	v.tr	w
think	kredi	v.tr.ntr believe	
unbelievable	nekredebla	adj.	w
incredulous	nekredema	adj. not credulous	w
skeptical	nekredema	adj. not credulous	w
beyond belief	preterkredeble	adv.	
incredibly	nekredeble	adv.	w
incredible	nekredebla	adj.	w
]

_tuŝ_ = [
touch	tuŝi	v.tr	
touch	tuŝo	n.	
affect	tuŝi	v.tr have an emotional impact on	
poignant	kortuŝa	adj. 	w
affect	kortuŝi	v.tr have an emotional impact on	
]

_supr_ = [
down	malsupren	adv. downward	
overhead	supre	adv.	w
upper	supra	adj. SHAPE	w
upstairs	supre	adv.	
top	supro	n.	
under	malsupre	adv.	
underneath	malsupre	adv.	
up	supren	adv.	
up here	ĉi tie supre	adv.	
up there	supre	adv.	
summit	supro	n.	
up above	supren de	phr.	w
lowered	malsuprenigis	v.tr	
aloft	supre	adv.	w
peak	supro	n.	w
treetop	arba supro	n.	w
]

_pens_ = [
invent	elpensi	v.tr	
wonder	pripensi	v.tr	w
think	pensi	v.ntr use brain, assume to be true	
consider	pensi	v.ntr	
ponder	pripensi	v.tr	w
think	pensas	v.ntr	
thought	pensis	v.ntr (+inf) intended to	
thought	penso	n.	
have been thinking	pensis	v.ntr	
don’t think	ne pensas	phr.	
thinking	pensanta	adj.	
unthinkable	nepensebla	adj.	w
think	ekpensi	v.ntr abruptly receive a thought	
made him think of that	ekpensigis pri tio	phr.	
think of it	ekpensi pri ĝi	phr. suddendly receive a thought	
wonder about	pripensi	v.tr	
reflect	pripensi	v.tr give thought about	
think of	pripensi	v.tr	
reflection	pripensado	n. the act of reflection on an issue	
reflective	pripensa	adj.	
reflective	pripensema	adj. thoughtful	
wistfully	pripense	adv.	w
pensive	pripensema	adj.	w
thoughtful	pripensema	adj. prone to reflection	w
thoughtless	senpripensa	adj.	w
wondering	pripenseme	adv.	w
]

# -SPERT- 
_spert_ = [
skilful	sperta	adj.	
experienced	sperta	adj.	w
expert	spertulo	n.	
expertise	sperteco	n.	
expertise	sperto	n.	
knowledgeable	sperta	adj.	
expert	sperta	adj. knowledgeable	w
experience	sperti	v.tr learn by experience	w
experience	sperto	n. that which is endured and knowledge thereby gained	w
]

_ekspert_ = [
study	ekspertizi	v.tr conduct a commissioned study or research report	
study	ekspertizo	n. conduct of a commissioned study	
]

#######

_sufiĉ_ = [
enough	sufiĉe	adv.	w
fairly	sufiĉe	adv.	w
inadequate	nesufiĉa	adj.	w
rather	sufiĉe	adv.	w
sufficiently	sufiĉe	adv.	w
so	sufiĉe	adv. sufficiently	
is not enough	ne sufiĉas	phr.	s
pretty	sufiĉe	adv. rather or quite	w
]

# -BRIL-
_bril_ = [
shone	brilis	v.ntr	
bright	brila	adj.	
brighter	pli brila	adj.	
dull	malbrila	adj. not visually bright	
gleams	brilas	v.ntr	
afterglow	postbrilo	n.	w
shines	brilas	v.ntr	
glittering	briletanta	adj.	w
flash	ekbrilo	n.	
glow	brilo	n.	
twinkling	ekbriletanta	adj.	w
radiance	brileco	n.	w
flare	brilego	n.	w
effulgence	brilegeco	n.	w
sunshine	sunbrilo	n.	w
moon-glitter	luna-brileto	phr.	w
shine out	elbrili	v.ntr	s
brilliant	brila	adj.	w
]

_lern_ = [
study	lerni	v.tr	w
learn	lerni	v.tr	
shall learn	lernos	v.tr	
learner	lernanto	n. before university	
school	lernejo	n. place where learning takes place	
middle school	mezlernejo	n. junior high school and high school, ~ grades 7-12	
pupil	lernanto	n. before university	
student	lernanto	n. before university	
elementary school	elementa lernejo	phr. the first six years or so of school	
high school	alta lernejo	n. college (grades 13 and above)	
came to learn	fin-lernis	v.tr finally learned	s
]

_pel_ = [
drive	peli	v.tr	w
impelling	pela	adj.	
dispel	dispeli	v.tr disperse	w
drove out	forpelis	v.tr	
banish	forpeli	v.tr	w
dislodged	elpelita	adj.	
]

# -VID-
_vid_ = [
see	vidi	v.tr	
saw	vidis	v.tr	
half-seen	duone-vidita	adj.	w
have seen	vidis	v.tr	
prevision	antaŭvido	n.	w
sightless	senvida	adj.	
sights	vidaĵoj	n. things looked onto	
visible	videbla	adj.	
is visible	videblas	v.ntr	
you see	vi vidu	phr. leads and explanation	w
you see	vidu	v.tr	w
seen	vidiĝi	v.ntr	
see again	revidi	v.tr	
having glimpsed	ekvidinte	adv.	
glimpse	ekvido	n.	w
invisible	nevidebla	adj.	
unseen	nevidita	adj.	w
would not see	ne vidus	phr.	
visually	vide	adv.	w
viewless	nevidebla	adj. poetic invisible or unseen	w
television	televidilo	n. individual instrument	w
television	televido	n. communication medium	w
are visible	videblas	v.ntr	
view	vidaĵo	n.	w
transparent	travidebla	adj.	w
wait and see	atendi kaj vidi	phr.	w
forecast	antaŭvido	n.	s
]


_tir_ = [
pull	tiri	v.tr	
attract	altiri	v.tr	w
drew	altiris	v.tr pulled or attracted	
drawing	tirante	adv. pulling	
drawn	altirata	adj.	
retire	retiriĝi	v.ntr withdraw	w
retreat	retiriĝo	n. WAR	w
draw away	fortiri	v.tr	w
drawing back	retirante	adv.	
shrink	retiriĝi	v.tr withdraw or recoil	
withdraw	retiri	v.tr eg withdraw a hand	w
withdraw	retiriĝi	v.ntr eg withdraw to higher ground	w
retires	retiras	v.tr	
draw away	fortiri	v.tr	
withdrew	retiriĝis	v.ntr	
shrank away	retiriĝis foren	phr.	w
]

_verŝ_ = [
pour	verŝi	v.tr pour a liquid	w
pour	verŝiĝi	v.ntr	w
pouring	verŝiĝanta	adj.	
]

_rimark_ = [
remarked	rimarkis	v.tr	
notice	rimarki	v.tr	w
notices	rimarkas	v.tr	
remark	rimarko	n.	w
mark	rimarki	v.tr notice	w
observe	rimarki	v.tr notice	w
unnoticed	nerimarkite	adv.
]

_rakont_ = [
tell	rakonti	v.tr	
tells	rakontas	v.tr	
story	rakonto	n. story recounted	w
]

# -DOLOR-
_dolor_ = [
hurt	dolori	v.tr	w
aches	doloras	v.tr normally followed by 'sin'	w
agony	dolorego	n.	w
pain	doloro	n.	w
horrible pain	dolorego	n.	
pain him	dolori sin	phr.	w
cause pain	dolori	v.tr	w
headache	kapdoloro	n.	w
]

# -PENTR-

_pentr_ = [
painting	pentraĵo	n. an artistic scene that is painted	w
oil painting	oleopentraĵo	n.	
paint	pentri	v.tr to paint as an artist	
paint	pripentri	v.tr to decorate with paint	
painter	pentristo	n. an artist who paints	
painterly	pentra	adj.	
painting	pentrado	n. the activity or manner of artistic painting	
painting	pentrarto	n. a physical artistic painting, the art itself of painting	
paints	pentras	v.tr	
seascape	marpentraĵo	n.	w
paint	pentri	v.tr	w
repaint	repentri	v.tr to repaint in an atristic way	
mural	murpentraĵa	adj. ART	w
painted	pentrita	adj. ART	w
]

_apart_ = [
particular	aparta	adj. specific	w
apart	aparta	adj.	
apart	aparte	adv.	w
separate	apartigi	v.tr make separate	
singularly	aparte	adv.	w
]

_pak_ = [
wrap up	paki	v.tr pack up	
parcel	pakaĵo	n. package	w
package	pakaĵo	n.	
]

# -SENT-
_sent_ = [
feel	senti	v.tr	
have a sense about	senti	v.tr	
felt	sentis	v.tr had an impression	
feeling	sento	n.	
sensation	sento	n. feeling	w
sense	sento	n. sensation, or state of consciousness	
suspicion	sento	n.	
sense	sentumo	n. insight, suspicion	
suspicion	sentumo	n.	w
insight	sentumo	n.	
sensitive	sentema	adj.	
sensitivity	sentemo	n.	w
sensibilities	sentemoj	n.	w
sentimental	sentimentala	adj.	
sentience	sentemo	n.	w
sensation	sentaĵo	n.	w
feel	eksenti	v.tr suddenly feel	
feel	sin senti	v.tr be conscious of eg feel hungry	
felt	sin sentis	phr.	
sensitive	sentiva	adj.tr reactive to stimulus	w
]

_flank_ = [
side	flanko	n.	
sideways	flanken	adv.	
side	flanko	n.	
on the other hand	aliflanke	adv.	w
flanked	flankita	adj.	
hillside	montetflanko	n.	w
on every hand	ĉiuflanke	adv. on every side	w

]

_tem_ = [
be about	temi	v.ntr (+pri)	
concern	temi	v.ntr (pri) be about	
concern	temi	v.ntr (pri) to be about	w
is a matter of	temi	v.ntr often used without a stated subject	
subject	temo	n.	
]

_sav_ = [
save	savi	v.tr rescue from danger	w
deliver	savi	v.tr save 	
rescue	savi	v.tr	
]

_esprim_ = [
expression	esprimo	n.	w
phrase	esprimo	n. turn of phrase	
turn of phrase	esprimo	n.	
inarticulate	neesprimiĝebla	adj.	w
]

_sku_ = [
shake	skui	v.tr	w
shake	skui	v.tr incl shaking one's head	w
shook	skuis	v.tr	
shaking	skuante	adv. incl shaking one's head	
shaken	skuita	adj.	
]

_kapt_ = [
seize	kapti	v.tr	
catch	kapti	v.tr	
clutched at	kaptis	v.tr	
caught	kaptiĝis	v.ntr become caught as in a trap	
clutching	ekkaptante	adv.	
would seize	kaptus	v.tr	
caught	kaptita	adj.	
snatch	forkapti	v.tr	
catching	kaptante	adv.	
benighted	nokte kaptita	adj.	w
]

# -FRAP-
_frap_ = [
strike	frapi	v.tr	w
stroke	frapo	n. a striking stroke	w
struck	frapita	adj.	w
knocking	frapado	n.	w
jarring	frapiĝo	n. result of impact	w
pat	frapeto	n. as in 'pat on the backside'	
pounding	frapado	n. knocking	w
tap	frapeto	n.	
]

_reg_ = [
rule	regi	v.tr.ntr 	w
control	regi	v.tr.ntr	w
manage	regi	v.tr.ntr	w
prevails	regas	v.tr.ntr	
reign over	regi	v.tr.ntr	w
government	registaro	n.	w
reign	regi	v.tr.ntr
self-possessed	memrega	adj.	w
]

_regn_ = [
realm	regno	n.	w
]

_kroĉ_ = [
grip	kroĉi	v.tr	
clinging	alkroĉiĝa	adj.	w
]

_kamp_ = [
field	kampo	n.	w
rural	kampara	adj.	w
farmhouse	kampara domo	n. complicated by ownership & serfdom	
fellahin	kamparanoj	n. from Arabic peasant farmer	
country	kamparo	n. as in countryside, not city	w
country people	kamparanoj	n.	
peasant	kamparano	n.	
rustics	kamparanoj	n.	w
field of grain	grenkampo	n.	s
]

_hak_ = [
hewing	hakanta	adj.	
hewn	elhakita	adj. shaped by hacking	
cutter	hakisto	n. one who cuts eg stone	
had cut it down	dehakis ĝin	phr.	
rock-hewn	rok-hakita	adj.	
]

_gvid_ = [
steering	gvido	n. guidance	
guide	gvidi	v.tr show the path	w
leadership	gvidado	n.
leader	gvidanto	n.
leadership	gvideco	n.	w
]

_hezit_ = [
hesitate	heziti	v.ntr	w
hesitation	hezito	n.	w
hesitatingly	hezite	adv.	w
lingeringly	hezite	adv. with hesitation	w
hesitation	hezitado	n.	w
]

_rezign_ = [
abandon	rezigni	v.tr	
abjure	rezigni	v.tr definitely leave as unworkable or unattainable	
gave up	rezignis	v.tr to abandon as unworkable	
give up	rezigni	v.tr	w
give up claims to	rezigni	v.tr	
renounce	rezigni	v.tr	
resignation	rezignacio	n. as a mental state	w
surrender	rezigni	v.tr	
renouncement	rezigno	n.	w
]

_ruin_ = [
ruined	ruina	adj. representing ruin, having been ruined	w
ruins	ruinoj	n. remains of ruined buildings	w
ruin	ruinigi	v.tr to ruin a thing	
ruined	ruinigis	v.tr	
wrecked	ruinigi	v.tr	w
]

_abund_ = [
plenty	abundo	n. abundance	w
lavishly	abunde	adv.	w
is everywhere rife	abundas	v.ntr	
scarce	malabunda	adj.	w
]

_afer_ = [
affair	afero	n.	w
issue	afero	n.	w
item	afero	n.	w
matter	afero	n.	
thing	afero	n.	
]

_pren_ = [
take	preni	v.tr	
took	prenis	v.tr	
taken	prenita	adj.	
take	forpreni	v.tr take away	
taking	prenanta	adj.	
would take	forprenus	v.tr would take away	
take	kunpreni	v.tr take with	w
fished out	elprenis fiŝe	phr.	
pick up	repreni	v.tr	w
assume	alpreni	v.tr	w
picked it up	prenis ĝin	phr.	
take back	repreni	v.tr	w
embrace	ĉirkaŭpreni	v.tr	
]

_stud_ = [
study	studi	v.tr carefully observe or as a student	w
study	studejo	n. place to study	w
]

_skrib_ [
write	skribi	v.tr produce letters lined up in rows	w
written	skriba	adj. produced by writing	w
written	skribita	adj.	
described	priskribita	adj.	
signature	subskribo	n.	
inscription	surskribo	n.	w
describe	priskribi	v.tr	
indescribable	nepriskribebla	adj.	w
beyond description	preterpriskribebla	adj.	w
]

_intenc_ = [
intend	intenci	v.tr	w
mean	intenci	v.tr intended action	
meant	intencis	v.tr intended action	
purpose	intenco	n. intention	w
to the intent	intence	phr.	
]

_paŝ_ = [
step	paŝo	n. a step in walking	
step back	retropaŝi	v.ntr	w
steps back	retropaŝas	v.ntr	
step	paŝado	n. stepping	w
paces	paŝas	v.ntr	w
footstep	paŝo	n.	
step inside	enpaŝi	v.ntr	
]

_klopod_ = [
endeavor	klopodi	v.ntr worry anxiously, made efforts to achieve something successful	w
manage	klopodi	v.ntr worry anxiously, made efforts to achieve something successful	
set about	klopodi	v.ntr worry anxiously, made efforts to achieve something successful	
busy oneself with	klopodi	v.ntr worry anxiously, made efforts to achieve something successful	
make efforts	klopodi	v.ntr worry anxiously, made efforts to achieve something successful	
deal with	klopodi	v.ntr worry anxiously, make efforts to achieve	
take steps	klopodi	v.ntr worry anxiously, made efforts to achieve something successful	
sought	klopodis	v.ntr worry anxiously, made efforts to achieve something successful	
]

_fleks_ = [
bent	fleksita	adj.	w
inflexibly	neflekseble	adv.	w
flexible	fleksebla	adj. bendable	w
flexible	fleksiĝema	adj. easily bendable	w
unbending	nefleksiĝe	adv. while not submitting	w
]

_abism_ = [
abyss	abismo	n.	w
gulf	abismo	n. abyss	w
abysmal	abisma	adj.	w
]

_civiliz_ = [
civilize	civilizi	v.tr to enlighten & make civilized 	w
civilization	civilizo	n. the act of civilizing 	w
civilization	civilizado	n. process aimed at the act of civilizing 	
civilized person	civilizito	n. 	
civilization	civiliziteco	n. state of civilized persons 	
civilisation	civilizo	n. the act of making one civilized	w
civilisation	civilizacio	n. society	w
]

_subit_ = [
short	subite	adv. suddenly as in stop-short	w
sudden	subita	adj.	w
suddenly	subite	adv.	w
suddenness	subiteco	n.	w
all at once	subite	adv.	w
]

_nov_ = [
new	nova	adj.	w
once more	denove	phr.	w
another	denove	adv. again	
old	malnova	adj.	w
over and over again	denove kaj denove	phr.	w
again	denove	adv.	
novice	novulo	n.	
]

_balanc_ = [
rock	balanci	v.tr rock something	
swing	balanci	v.tr	
bobbed	balanciĝis	v.ntr	
swinging	balanciĝi	v.ntr	
overbalanced	tro balanciĝis	v.ntr	w
]

_zorg_ = [
attend to	zorgi	v.tr.ntr	w
care for	zorgi	v.tr.ntr	w
tend	zorgi	v.tr.ntr normally plus pri	w
tend	prizorgi	v.tr.ntr	
take responsibility for	zorgi	v.tr.ntr	
care	zorgo	n. concern and responsibility	
careless	senzorga	adj. untroubled	
concern	zorgigi	v.tr.ntr cause concern or worry to	
recklessness	malzorgemo	n.	w
take care of	prizorgi	v.tr a sick person or a garden	
worry about	prizorgi	v.tr	
worry	zorgigi	v.tr cause to worry or be concerned	
take care of	prizorgi	v.tr	
taking care	zorgante	adv.	
mind	zorgi	v.tr.ntr be bothered by	w
]

_aĉet_ = [
buy	aĉeti	v.tr COMMERCE	
bought	aĉetis	v.tr	
buying	aĉetanta	adj.	
]

_harzard_ = [
chance	hazardi	v.tr leave to chance	w
at random	hazarde	adv.	w
]

_serĉ_ = [
pursuit	serĉo	n.	
search	serĉo	n.	w
searchingly	serĉe	adv.	w
prying	serĉanta	adj.	
seeking	serĉanta	adj.	w
blundered about	fuŝe serĉis	phr. searched blunderingly	
]

_form_ = [
form	formo	n. ie shape	
form	formi	v.tr	w
shaped	formita	adj.	w
uniform	unuforma	adj. nonvarying	w
amorphous	senforma	adj. lacking shape	w
amorphous	senforma	adj. non-crytalline	w
shapeless	senforma	adj.	w
shape	formo	n. SHAPE	w
oblong	longforma	adj. SHAPE	w
]

_angul_ = [
angle	angulo	n.	w
corner	angulo	n.	w
triangular	triangula	adj.	w
corner	stratangulo	n. street corner	w
]

# -PROKSIM-
_proksim_ = [
near	proksima	adj.	w
close	proksime	adv. closely	
roughly	proksimume	adv.	w
nearer	pli proksimen	phr.	
closer	pli proksime	adv.	
nearest	plej proksime	adv.	
closest	plej proksima	phr.	
approximate	proksimumi	v.tr	w
approach	alproksimiĝi	v.ntr	w
drew nigh	alproksimiĝis	v.ntr approached	
draws near	alproksimiĝas	v.ntr	w
far	malproksime	adv.	
in distance	malproksime	adv. far away	w
far away	malproksime	adv.	w
]

_venk_ = [
succumb	venkiĝi	v.ntr	w
victor	venkanto	n. one who conquers and is victorious WAR	w
defeat	malvenko	n. WAR	w
]

# -POV-
_pov_ = [
can	povas	v.tr has the ability to	
can’t	ne povas	phr.	
can't	ne povi	v.tr	w
cannot	ne povas	phr.	w
was able	povis	v.tr	w
be able to	povi	v.tr be able to do something	
couldn't	ne povus	phr.	
could	povis	v.tr	
couldn’t	ne povis	v.tr	
impotent	senpova	adj.	w
could	povus	v.tr	
know how to	povi	v.tr	
know how to	scipovi	v.tr more specific form of povi	
can it be	ĉu povas esti	phr.	s
]

_forges_ = [
forget	forgesi	v.tr	w
forgot	forgesis	v.tr	
forgotten	forgesinta	adj. forgot, not was forgotten	
forgotten	forgesita	adj. was forgotten	
forgetfulness	forgesemo	n.	
shall never forget	neniam forgesos	phr.	
]

_flu_ = [
flows	fluas	v.ntr	
running	fluanta	adj. flowing	
stream	fluo	n.	w
undercurrent	subfluo	n.	
extra bit	superfluo	n.	
effluence	elfluo	n.	w
well up	suprenflui	v.ntr	w
gutter	defluilo	n.	w
fliessandes	fluanta	adj. German, flowing	s
]

_influ_ = [
influence	influi	v.tr	w
influence	influo	n.	w
influential	influa	adj.	w
affect	influi	v.tr affect or influence	
]

_aspekt_ = [
appear	aspekti	v.ntr how one looks to others	w
appearance	aspekto	n.	w
aspect	aspekto	n.	w
look	aspekti	v.ntr appear as, how one looks to others	w
visage	aspekto	n. appearance	w
to look at	laŭ aspekte	phr. in terms of appearance	
]

_kaŝ_ = [
conceal	kaŝi	v.tr	w
hid	kaŝis	v.tr	
hidden	kaŝita	adj.	w
hides	kaŝas	v.tr	w
slyly	kaŝe	adv.	
openly	malkaŝe	adv. revealingly as in talk openly	w
stealth	kaŝeco	n.	w
disclose	malkaŝi	v.tr	w
hiding-place	kaŝejo	n.	w
]

_verk_ = [
compose	verki	v.tr	w
write	verki	v.tr	w
work	verko	n.	w
writer	verkisto	n. PUBLISH	w
masterpiece	ĉefverko	n.	w
]

# -DIR-
_dir_ = [
say	diri	v.tr	
remark	diri	v.tr	
tell	diri	v.tr	
said	diris	v.tr	
told	diris	v.tr	
had told	diris	v.tr	
saying	diranta	adj.	
spoken	dirita	adj.	w
uttered	eldirita	adj.	w
unsay	maldiru	v.tr	w
would tell	dirus	v.tr	
I tell you	mi diras al vi	phr.	
it is said	oni diras	phr.	
rumour	onidiro	n.	w
gossip	onidiro	n. rumor, positive or negative	
muttered	murmurdiris	v.tr TALK	w
muttering	murmurdirante	adv.	
mutter	murmurdiri	v.tr	w
to say a word	diri eĉ vorton	phr. idiom 	w
mean	volas diri	phr. correct a thing mis-spoken	w
]

# -KONSTERN-
_konstern_ = [
consternation	konsterno	n.	w
disconcerted	konsternita	adj.	w
dismayed	konsternita	adj.	w
startled	konsternite	adv.	
started	konsterniĝe resaltis	phr. recoil from being startled	w
startled	konsternis	v.tr past tense of startle	w
starts	ekkonsterniĝas	v.ntr is started	w
]

_grup_ = [
group	grupo	n.  	w
group	grupigi	v.tr make a group 	w
group	grupiĝi	v.ntr become a group 	w
]

_ag_ = [
act	ago	n. action	w
action	ago	n.	w
act	agi	v.ntr make an action	w
]

_sekur_ = [
safe	sekura	adj.	w
safest	plej sekure	phr.
]

_solid_ = [
dense	solida	adj.	
massive	solida	adj.dense	
consolidate	solidigi	v.tr
]

_util_ = [
useful	utila	adj.	w
benefit	utili	v.tr.ntr bring benefit	w
be of use	utili	v.tr.ntr bring benefit	
avail	utiligi	v.tr avail oneself, take advantage of	w
useless	senutila	adj.	w
have done you harm	malutilis al vi	phr.	
does you harm	malutilas al vi	phr.	
harm	malutilo	n. practial harm	
it's no use	ne utilas	phr.	w
]

_serioz_ = [
serious	serioza	adj.	w
seriously	serioze	adv.	w
grave	serioze	adv. serious not flippant	
earnest	serioza	adj.	
in earnest	serioza	adj.	w
somber	serioza	adj.	w
gravely	serioze	adv.	w
made light of it	traktis ĝin malserioze	phr.	w
]

_jun_ = [
old	maljuna	adj.	w
grown old	maljuniĝinta	adj.	
youthful	juneca	adj.	w
old lady	maljunulino	n.	
old man	maljunulo	n.	w
old people	maljunuloj	n.	
old person	maljunulo	n.	
young person	junulo	n.	w
youth	junulo	n. young person	w
young	juna	adj.	w
youth	juneco	n. being young	w
teenager	junulo	n.	w
older	pli maljuna	adj.	
]

_labor_ = [
labour	laboro	n.	
labourer	laboristo	n.	w
work	labori	v.ntr	
workman	laboristo	n.	w
earn	perlabori	v.tr	
foreman	laborestro	n.	w
hardworking	laborema	adj.	w
drudgery	teda laborado	n. tedious ongoing work	
]

_mond_ = [
world	mondo	n.	w
worldly	monda	adj.	w
on earth	en la mondo	phr. in the world	w
]

_mens_ = [
mind	menso	n.	
mindless	senmensa	adj. not having a mind	
sane	mense sana	adj.	w
mental	mensa	adj. psych, use 'psika' when technical	w
mentally	mense	adv. psych, use 'psike' when technical	w
mental blank	mensa malpleno	phr.	w
]

_konfuz_ = [
confusion	konfuzo	n.	
puzzled	konfuzita	adj.	w
dazed	konfuzite	adv.	w
muddled	konfuzita	adj.	w
bewildering	konfuzanta	adj.	w
bewilderment	konfuzo	n.	w
it puzzled	konfuzis	v.tr	w
]

_mirakl_ = [
miraculously	mirakle	adv.	w
]

_admir_ = [
awe	admiro	n. admiration	
awed	admirante	adv.	
admiration	admiro	n.	w
admirer	admiranto	n.	w
admiringly	admirante	adv.	w
]

# -MIR-
_mir_ = [
awe	miro	n.	w
amazement	miro	n.	w
awed	mirigite	adv. with surprise	
fantastic	mirinda	adj. such as to cause amazement	
amazement	mirigeco	n.	w
amaze	mirigi	v.tr	w
astonish	mirigi	v.tr	w
amazing	miriga	adj.	w
wondrous	mirinda	adj.	w
wonder	mirindaĵo	n. wonderful thing	w
wonderful	mirinda	adj.	w
wonder	miro	n.	w
wonderful thing	mirindaĵo	n.	
marvellous	mirinda	adj.	w
amazingly	mirinde	adv.	w
astounding	miriga	adj.	
little wonder	ne mirinde	phr.	w
]

_spec_ = [
type	speco	n.	
sort	speco	n.	
kind	speco	n.	w
of a different sort	malsamaspeco	n.	
of some sort	iaspeca	adj.	
]

_grav_ = [
importance	graveco	n.	w
matters	gravas	v.ntr	w
slight	malgrava	adj. not serious	
unimportant	negrava	adj.	
significantly	grave	adv.	
it’s nothing	tute ne gravas	phr. reassuring words	
lesser	malpli grava	phr. less serious	
no matter	ne gravas	v.ntr	w
]

_lac_ = [
tired	laca	adj.	w
wearily	lace	adv.	w
weary	laca	adj.	w
tire	lacigi	v.tr to make one tired	w
weariness	laceco	n. fatigue	w
would tire	lacigus	v.tr	
weary	laciga	adj.tiring	w
exhaustion	lacego	n.	w
grew tired	laciĝis	v.ntr	
exhausted	lacega	adj. very tired	
]

_send_ = [
sent away	forsendis	v.tr	
refer	plusendi	v.tr something to someone	w
send on to	plusendi	v.tr send something to someone	
sending	sendi	v.tr	
sent	sendis	v.tr	
dismiss	forsendi	v.tr send away	w
would send	sendus	v.tr	
send away	forsendi	v.tr	
transmitter	sendilo	n. eg radio	w
]

_voc_ = [
voice	voĉo	n.	
voiceless	senvoĉa	adj.	
unvocal	senvoĉa	adj. 	w
smoothly	glatvoĉe	adv. using a smoothly tone of voice	
]

# -IMAG-
_imag_ = [
imagine	imagi	v.tr	w
fancied	imagis	v.tr	
picture	imagi	v.tr imagine	w
imagination	imago	n.	w
imaginative	imagema	adj.	w
imagined	imagata	adj. ant. reala	w
inconceivable	neimagebla	adj. unimaginable	w
may be imagined	eble estus imagata	phr.	
unimaginable	neimagebla	adj.	w
fancy	imago	n. imagination	w
]

_not_ = [
note	noti	v.tr make note of, written or mentally	w
note	noto	n. short reminder written to yourself	w
mark	noti	v.tr make note of	w
record	noti	v.tr	w
]

_pretend_ = [
claim	pretendi	v.tr claim something to which one claims to have a right	
unpretentious	senpretenda	adj.	w
claim	pretendo	n. assertion of right, subject of dispute, assertion of qualities	
pretence	pretendo	n. claim of having a right or flattering qualities	w
]

_maĉ_ = [
chewing	maĉo	n.	w
crisp	krakmaĉa	adj.	w
crunchy	krakmaĉa	adj.	w
]

_favor_ = [
be favorable toward	favori	v.tr	
favor	favori	v.tr be favorable toward	w
favored	favorata	adj.	
favourable	favora	adj. eager to grant advantage to	
favoured	favoris	v.tr	
boon	favoro	n. favor granted	w
favour	favoro	n.	w
favour	favoroj	n.	w
]

_dom_ = [
house	domo	n.	w
manor	domego	n.	
manor house	domego	n.	
mansion	domego	n.	
loss	domaĝo	n. regrettable loss actual or potential	
outdoor	eksterdoma	adj.	
within doors	intern'dome	adv.	
]

_konsekv_ = [
consequently	konsekvence	adv.	
consistent	konsekvenca	adj.	
consistently	konsekvence	adv.	
logical	konsekvenca	adj.	
logical result	konsekvenco	n.	
orthodox	konsekvenca	adj.	
therefore	konsekvence	phr.	
]

_sekv_ = [
consequence	sekvo	n.	
consequently	sekve	adv.	
fall-out	sekvo	n.	
follow	sekvi	v.tr	
next	sekva	adj.	w
sequence	sekvenco	n.	
subsequent event	sekvo	n.	
subsequently	sekve	adv.	
thus	sekve	adv.	
would ensue	sekvus	v.tr	
succession	sinsekvo	n.	w
following	sekva	adj. subsequent	w
following	sekvante	adv.	
]

_konstant_ = [
permanent	konstanta	adj. not changing with time	
regular	konstanta	adj. not changing with time	
constantly	konstante	adv.	w
]

klasik_ = [
classic	klasika	adj.	w
classical	klasika	adj.	w
]

_last_ = [
last	lasta	adj. after all the others	
latter	lasta	adj.	
recent	lasta	adj.	w
latest	lasta	adj.	w
latter	ĉi-lasta	adj. refering to the second of two, near the end, or closer to now	w
]

_streĉ_ = [
exertion	streĉo	n.	
great effort	streĉo	n.	
pull longer	streĉi	v.tr	
strain	streĉi	v.tr	
stretch	streĉi	v.tr	
stretching	streĉa	adj. causing tension	
tense	streĉa	adj. eg re people, situations, stories, relations	w
tension	streĉo	n.	w
tightly wound up	streĉita	adj.	
wind	streĉi	v.tr wind a watch	
tense	streĉita	adj. eg tense voice	w
tense	streĉita	adj. eg tense voice	w
]

_sukces_ = [
fail	malsukcesi	v.ntr	w
fail	malsukcesigi	v.tr	w
unsuccessful	sensukcesa	adj. unsuccessful as a single event	
succeed	sukcesi	v.ntr	w
success	sukceso	n.	w
]

_fiks_ = [
fix	fiksi	v.tr attach to a place	
stuck	fiksite	adv.	
fastened itself	fiksiĝis	v.ntr	
attached	alfiksata	adj.	w
had fastened on	fiksiĝis	v.ntr	
jammed	fiksiĝis	v.ntr	
loose	malfiksa	adj.	
loosen	malfiksi	v.tr	w
fastened	alfiksita	adj.	
fastened	fiksita	adj.	
was not fixed	ne estis fiksita	adj.	
]

_las_ = [
leave	lasi	v.tr	w
left	lasis	v.tr to leave behind	
let	lasi	v.tr	w
leave	forlasi	v.tr go away from	w
left	forlasita	adj. not taken	
let in	enlasi	v.tr	w
desert	forlasi	v.tr	w
omission	preterlaso	n.	w
quit	forlasi	v.tr	w
desertion	forlasiĝo	n. abandonment	w
let go	delasi	v.tr	w
]

_kontrol_ = [
check	kontroli	v.tr	w
check out	kontroli	v.tr	
inspect	kontroli	v.tr	w
supervise	kontroli	v.tr	
]

_nombr_ = [
countless	nenombrebla	adj. MATH	w
manifold	multnombra	adj.	w
counter	nombrilo	n. numbering device 	
numerous	multnombra	adj. 	w
unnumbered	ne nombrataj	adj. too many to keep up with	w
]

_demand_ = [
ask	demandi	v.tr inquire, ask about something TALK	w
question	demando	n. TALKING	w
questioningly	demande	adv.	w
inquiry	demandado	n. ongoing questions	w
]

_postul_ = [
demand	postuli	v.tr	w
require	postuli	v.tr	w
exacting	postulema	adj. demanding	w
claim	postuli	v.tr express one's will that someone give or do something	
]

_barakt_ = [
flounder	barakti	v.ntr	w
struggling	baraktanta	adj. ntr	
struggled	baraktis	v.ntr	w
struggle	barakto	n.	w
]

_krut_ = [
steeply	krute	adv.	w
cliff	krutaĵo	n. any cliff, a steep place	w
steep	kruta	adj. sloping greatly	w
precipitous	krutega	adj.	w
]

_okup_ = [
occupy	okupi	v.tr	
occupy oneself	okupiĝi	v.ntr	w
busy	okupita	adj.	
idle	senokupa	adj.	w
idly	senokupe	adv.	w
held	okupis	v.tr occupied	
taken up with	okupita pri	phr.	
]

_prefer_ = [
prefer	preferi	v.tr	w
preferred	preferata	adj.	
favorite	preferata	adj. preferred	
would rather	preferus	v.tr	
]

_dezir_ = [
wish	deziri	v.tr	w
wishes	deziras	v.tr	
wish	deziro	n.	w
desire	deziri	v.tr	w
desire	deziro	n.	w
désirée	dezirata	adj. French, desired one	
]

_dik_ = [
bulky	dika	adj. plump	w
stout	dika	adj.	
plump	dika	adj.	w
thinly	maldike	adv.	w
fat	dika	adj. of people or animals	
thick	dika	adj.	w
thin	maldika	adj.	w
]

_vag_ = [
tramp	vagado	n. wandering	w
wandering	vagi	v.ntr	w
roving	vaganta	adj.	w
]

_prem_ = [
press	premi	v.tr	w
pressing up	premadi	v.tr	
pressure	premo	n.	w
clasping	kunprema	adj.	
crush	dispremi	v.tr	w
pressed about	kunpremiĝis ĉirkaŭ	phr. squeezed into a surrounding crowd	
stifling	subpremanta	adj. opporessive or subpressive	w
caked	kunpremita	phr. eg caked-sand	w
pent-up	subpremita	adj.	w
]

_premi_ = [
prize	premii	v.tr	
prize	premio	n.	w
]

_ŝrank_ = [
case	ŝranko	n. eg display-case	w
cabinet	ŝranko	n.	
clothes closet	ŝranko	n.	
cupboard	ŝranko	n.	w
mantel	kamenŝranko	n. mantelpiece	w
]

_vort_ = [
word	vorto	n. incl verbal promise	w
password	pasvorto	n.	w
literally	laŭvorte	adv.	w
upon my word	je mia vorto	phr.	w
]

_fad_ = [
faded	fadis	v.ntr	w
began to fade	ekfadis	v.ntr	
faded away	fadis	v.ntr	w
faded out	fadis	v.ntr	w
]

_kirl = [
stir	kirli	v.tr	w
whirl	kirliĝi	v.ntr	
curling	kirliĝanta	adj.	
scramble	kirliĝo	n.	
swirling	kirliĝanta	adj.	w
]

_tag_ = [
day	tago	n.	w
in the daytime	tage	adv.	w
daily	ĉiutage	adv.	w
two days later	du tagojn poste	adv.	
dawn	tagiĝe	adv.	w
dawn	tagiĝo	n.	w
just at dawn	ĝuste je tagiĝo	phr.	w
all day	dum la tuta tago	phr.	
birthday	naskiĝtago	n.	w
]

_garanti_ = [
guarantee	garantio	n.	
guaranteeing	garantiante	adv.	
surety	garantiulo	n.  a hostage given as guarantor	w

]

# -ESPER-
_esper_ = [
despairing	malespera	adj.	w
hopelessness	senespereco	n.	
hopeless	senespera	adj.	
hope	esperi	v.tr	
hope for	esperi	v.tr	
hopeful	esperplena	adj.	w
hopefully	espereble	adv.	w
in the hope of	esperante	adv.	
despair	malespero	n.	
desperately	malespere	adv.	w
forlorn	malespera	adj.
hope so	esperas jes	phr.	s
]

_flag_ = [
flag	flagi	v.tr adorn with a flag	w
flag	flago	n.	
]

_pacienc_ = [
patiently	pacience	adv. EMOTION	w
impatient	senpacienca	adj.	w
patience	pacienco	n.	w
]

_gajn_ = [
earn	gajni	v.tr money	
gain	gajni	v.tr	
win	gajni	v.tr money	
]

_lign_ = [
wood	ligno	n.	w
wooden	ligna	adj.	w
]

_koncern_ = [
worry	koncerno	n.	
affect	koncerni	v.tr to concern, relate to, affect	
concern	koncerni	v.tr	
relate to	koncerni	v.tr	
]

_rimed_ = [
resource	rimedo	n.	w
device	rimedo	n.	
means	rimedo	n.	
medium	rimedo	n.	
solution	rimedo	n.	
]

_lok_ = [
displaced	delokitaj	adj.	
displacement	delokeco	n.	
local	loka	adj.	
place	loko	n.	
seat	sidloko	n. place to sit	w
spot	loko	n.	w
elsewhere	aliloke	adv.	w
]

_protest_ = [
protest	protesto	n.	2
remonstrance	protesto	n.	w
acquiescence	malprotesto	n.	w
]

_fiask_ = [
failure	fiasko	n. 	w
]

_lum_ = [
dim	mallumeta	adj. not bright	
dimness	mallumo	n.	w
light	lumo	n. lit. or fig. visible radiation, light source, or part of painting	
radiance	lumeco	n.	w
illuminating	lumiganta	adj.	w
luminous	luma	adj.	w
lit	lumigita	adj.	w
darkened	mallumigita	adj.	
darkness	mallumo	n.	w
dimming	mallumiĝanta	adj.	
semidarkness	duonmallumo	n.	
dark	malluma	adj. lacking light, gloomy, irrational, evil	
sunlit	sunlumita	adj.	w
moonlight	lunlumo	n.	w
moonlit	lunluma	adj.
starlight	stellumo	n.	w
starlit	stelluma	adj.	
dawn-lit	tagiĝo-lumigita	adj. 	
dimness	mallumeco	n.
darker	pli malluma	adj.	w
]

_long_ = [
long	longa	adj.	w
length	longo	n.	w
yearlong	jarlonga	adj.	w
long	longe	adv. for a long time	w
brief	mallonga	adj.	w
briefly	mallonge	adv.	
recently	antaŭ nelonge	adv.	w
long gone	for jam longe	phr.	
longer	pli longe	adv.	
at length	laŭlonge	adv.	w
long since	antaŭlonge	adv.	w
]

_oblong_ = [
oblong	oblonga	adj. SHAPE	w
]

_temp_ = [
time	tempo	n. as in 'time of day'	
recently	lastatempe	adv.	w
only a while ago	antaŭ nur iom da tempo	phr.	
present day	nuntempo	n.	
these days	nuntempe	adv.	w
at the same time	samtempe	adv.	w
interval	intertempo	n. time between events	w
at the same time	samtempe	adv.	w
at the time	tiutempe	adv.	w
simultaneously	samtempe	adv.	W
for the nonce	nuntempe	adv.	w
ancient	pratempa	adj.	
at any other time	en ajna alia tempo	phr.	
at such a time	je tia tempo	phr.	
a bit	iom da tempo	phr. a bit of time	
awhile	dum iom da tempo	phr.	w
for a little	dum iom da tempo	phr.	
little while	dum iom da tempo	phr. a little while	
all the time	dum la tuta tempo	phr.	
in due course	post iom da tempo	n.	
spent time	pasigis tempon	phr.	w
at once	samtempe	adv. at the same time	w
in time	ĝustatempe	adv.	w
at the time	je la tempo	phr.	w
]

_praktik_ = [
practical	praktika	adj. not theoretical	
practical experience	praktiko	n. as against theory	
practice	praktiki	v.tr practice a profession	
practice	praktiko	n. as against theory	
profession	praktiko	n. as against theory	
are practiced	praktikitaj	adj.	
]

_pruv_ = [
proof	pruvo	n.	
show	pruvi	v.tr by reasoning	
prove	pruviĝi	v.ntr show oneself to be	w
prove	pruvi	v.tr	w
]

_hom_ = [
human being	homo	n.	w
humanity	homaro	n. all humans	w
man	homo	n. gender-neutral sense	
people	homoj	n.	w
human	homa	adj.	w
man	homaro	n., humanity	
deserted	senhoma	adj.	
inhuman	nehoma	adj.	w
mankind	homaro	n.	w
crowd	homamaso	n.	
crowded	homamasa	adj. consider homplena as preferable	
]

_vizit_ = [
visit	viziti	v.tr	w
pay a visit to	viziti	v.tr	w
frequent	vizitadi	v.tr visit regularly	w
]

_kav_ = [
cavity	kavo	n.	
hole	kavo	n.	
hollow	kava	adj.	
dimple	kavo	n.	
sunken	kava	adj.	
sunken spot	kavo	n.	w
eye-socket	kavo	n.	w
]

_afabl_ = [
kindly	afabla	adj.	w
kindness	afableco	n.	w
kind	afabla	adj.	
]

_font_ = [
font	fonto	n.	
origin	fonto	n.	
source	fonto	n.	
spring	fonto	n. water source	
fountain	fonto	n.	
]

_fontan_ = [
fountain	fontano	n.	w
]

_stabl_ = [
trestle	stablo	n.	
workbench	stablo	n.	w
workstand	stablo	n.	w
easel	stablo	n.	w
]

# -FARB-
_farb_ = [
paint	farbi	v.tr to apply paint, non-artistically	
paint	farbo	n. liquid paint medium	
painter	farbisto	n. non-atristic painter	
airbrush	pistolfarbi	v.tr to paint with a sprayer	
spraypaint	pistolfarbi	v.tr to paint with a sprayer	w
watercolor	akvofarbo	n.	
]

# -TIM-
_tim_ = [
fear	timo	n.	w
afraid	tima	adj.	w
frightened	tima	adj.	w
am afraid	timas	v.tr	
fears	timas	v.tr	
was afraid	timis	v.tr	
daunt	timigi	v.tr	w
frightful	timiga	adj.	w
was not afraid	ne timis	v.tr	
frightfully	timige	adv.	w
making him fearful	timigante lin	phr.	
fearsomely	timige	adv.	w
dread	timeginda	adj. worthy of great fear	
apprehension	antaŭtimo	n.	w
frightens	timigas	v.tr	w
lest	pro timo ke	phr. for fear that	
dread	timego	n.	w
for fear of	timante	adv. 	w
fear	timiĝi	b.ntr	w
]

_sinjor_ = [
sir	sinjoro	n.	
madam	sinjorino	n.	
gentleman	sinjoro	n.	w
gentlemen	sinjoroj	n.	w
Lord	Sinjoro	n. 	w
Lord	Sinjoro	n. 	w
lady	sinjorino	n.	w
]

_sid_ = [
sit	sidi	v.ntr	w
sat	sidis	v.ntr	
sat on	sidadis	v.ntr continued to sit	
sat out	sidis rande	adv.	
sitting up	sidiĝante rekte	phr.	
sits up	rekte sidiĝas	phr.	
sitting-out	sidi rande	phr. sitting on the side-lines	
]

_perpleks_ = [
perplexed	perpleksa	adj.	w
bewildered	perpleksa	adj.	w
]

_anim_ = [
soul	animo	n.	w
silly	facilanima	adj. light-hearted	w
lighthearted	facilanima	adj.	w
old faithful soul	fidelanimulon	phr.	
light-heartedly	facilanime	adv. easy-going, lit. easy-souled	w
shade	ombra animo	phr. shadowy spirit	
]

_amas_ = [
pile	amaso	n.	w

mass	amaso	n.	
amass	amasigi	v.tr	w
in large quantities	amase	adv.	
crowd	amaso	n.	
mob	amaso	n.	w
throng	amaso	n.	w
in throngs	amase	adv.	
flock	amasiĝi	v.ntr to pile up or become a crowd	w
]

_reĝ_ = [
king	reĝo	n.	w
queen	reĝino	n. 	w
]

_alud_ = [
allude to	aludi	v.tr	
speak of	aludi	v.tr	
hint	aludi	v.tr	w
reference	aludo	n. indirectly mentioning a thing	
referring to	aludante	adv.	
]

_traf_ = [
attain	trafi	v.tr to attain a goal	w
catch	trafi	v.tr catch a bus etc	
hit	trafi	v.tr to hit a target	w
stricken	trafita	adj.	
comes over	trafas	v.tr as in 'fear comes over me'	
came over	trafis	v.tr as in "disappointment came over him"	w
]

_ĉiz_ = [
chisel	ĉizi	v.tr	w
chisel	ĉizilo	n.	w
chiselled	ĉizita	adj.	
carven	ĉizita	adj. ART	w
carving	ĉizaĵo	n. ART	w
]

_dank_ = [
thank	danki	v.tr	
thank you	dankon	n.	w
it was nothing	ne dankinde	phr. you’re welcome	
no problem	ne dankinde	interj. you’re welcome	w
you’re welcome	ne dankinde	adv.	w
]

_fantazi_ = [
fantasy	fantazio	n.	w
conceit	fantazio	n. a sort of thought	
fancies	fantazioj	n.	w
fanciful	fantazia	adj.	w
fantastic	fantazia	adj. imaginative, irregular, unreal	
]

_observ_ = [
observe	observi	v.tr	
violate	malobservi	v.tr transgress	w
]

_ofic_ = [
office	ofico	n. professional position	w
office	oficejo	n.	w
]

_natur_ = [
natural	natura	adj.	w
nature	naturo	n.	w
uncannily	preternature	adv.	w
naturalist	naturalisto	n. SCHOOL	w
eery	preternatura	adj.	
eldritch	preternatura	adj.	w
uncanny	preternatura	adj.	w
unnatural	kontraŭnatura	adj. 	w
]

_fantom_ = [
ghosts	fantomoj	n.	w
ghostly	fantome	adv.	w
spectral	fantoma	adj. 	w
spectrally	fantome	adv. 	w
]

_direkt_ = [
direct	direkti	v.tr eg questions; one’s feet; a hose; or tourist	
direction	direkto	n.	w
guide	direkti	v.tr	
manage	direkti	v.tr	
bound	direktiĝas	v.ntr heading for	
govern	direkti	v.tr	
]

_sorĉ_ = [
witch	sorĉistino	n.	w
enchanted	ensorĉita	adj.	w
bewitched	sorĉita	adj.	w
has cast a glamour over	prisorĉis	v.tr	w
]

_nask_ = [
be born	naskiĝi	v.ntr	w
born	naskita	adj.	
well born	bone naskita	phr. aristocratic	w
Christmas	Kristnasko	n.	w
hell-born	infere naskita	phr. 	w
Chrismasse Carolles	Kristnaskaj Karoloj	n.	
Christmas Morning	Kristnask’mateno	n.	
Christmas-day	Kristnaska tago	n.	w
Christmas-eve	Kristnaska Vespero	n.	w
Christmas-tide	Kristnask’tempo	n.	
]

_preĝ_ = [
prayer	preĝo	n.	
church	preĝejo	n.	
temple	preĝejo	n. a building lit. place to pray	
synagogue	preĝejo	n. place to pray	
]

_profet_ = [
prophet	profeto	n.	w
prophesied	profetis	v.tr.ntr	
prophesies	profeti	v.tr make prophesy	
prophesy	profeti	v.tr	w
prophetic	profeta	adj.	w
prophecies	profetaĵoj	n. things foretold by prophesy	
]

_malic_ = [
evil	malica	adj. malicious	w
viciousness	maliceco	n.	w
]

_asoci_ = [
associate	asocii	v.tr	w
association	asocio	n.	w
associated with	asociita kun	phr.	
]

_evit_ = [
avoid	eviti	v.tr	w
dodge	eviti	v.tr avoid	w
shun	eviti	v.tr	w
elusively	eviteme	adv.	w
]

_kompar_ = [
comparison	komparo	n.	w
compare	kompari	v.tr	w
compared to	kompare kun	phr.	
compared to that	kompare kun tio	phr.	
]

_stat_ = [
state	stato	n. condition of being; incl states of the USA	w
situation	stato	n.	w
condition	stato	n.	w
]

_aranĝ_ = [
contrive	aranĝi	v.tr	w
arrange	aranĝi	v.tr	w
array	aranĝo	n. arrangement	w
dispose	aranĝi	v.tr	w
been arranged	aranĝita	adj.	
]

_senc_ = [
meaning	senco	n. the way a word is to be understood	w
sense	senco	n. way in which a word etc is to be understood	w
nonsense	sensenca	adj.	w
in a certain sense	iusence	adv.	w
]

_band_ = [
gang	bando	n.	w
band	bando	n. group of musicians	w
]

# -TERUR-
_terur_ = [
horror	teruraĵo	n. object causing horror	w
horror	teruro	n. great fear	w
awfully	terure	adv.	
horrible	terura	adj. such as to evoke terror or very strong	w
terrible	terura	adj.	w
terrifies	teruras	v.tr	
awful	terura	adj. such as to evoke terror or very strong	
terror	teruraĵo	n. a thing that inspires terror	w
horribly	terure	adv. in a terrible way or an extreme way	w
]

_fos_ = [
bury	enfosi	v.tr	w
dug	fosis	v.tr	w
pit	tombofoso	n. grave pit	w
]

# -TOMB-
_tomb_ = [
tomb	tombo	n.	w
grave	tombo	n.	w
charnel	tomba	adj.	w
burial	entombigo	n.	w
graveyard	tombejo	n.	w
cemetery	tombejo	n.	w
gravestone	tomboŝtono	n.	
]

_salut_ = [
hail	saluti	v.tr	w
greet	saluti	v.tr	w
salute	saluti	v.tr	w
]

_kulp_ = [
guilt	kulpo	n.	w
fault	kulpo	n.	w
is at fault	kulpas	v.ntr	w
blame	kulpigi	v.tr	w
]

_tumult_ = [
commotion	tumulto	n.	w
riot	tumultiĝi	v.ntr	w
upheaval	tumulto	n.	w
]

_fervor_ = [
fervently	fervore	adv.	w
vehemently	fervore	adv. EMOTION	w
]

_hast_ = [
haste	hasto	n.	w
hastily	haste	adv.	w
hasty	hastema	adj.	
hasty	hasta	adj.	w
]

_pez_ = [
heavy	peza	adj.	w
weight	pezo	n.
weigh	pezi	v.ntr to have a weight of an amount	w
weigh upon	pezi	v.ntr as a burden	
lightly	malpeze	adv.	w
light	malpeza	adj. lit. or fig. not heavy	w
lightest	plej malpeza	adj. least heavy	w
]

_mult_ = [
a lot of	multa	adj. many	w
many	multaj	adj.	
far more	multe pli	phr.	
little	malmulte	adv.	
much	multa	adj. generally avoided in the singular in favor of multe da	
much	multe	adv.	
to a great extent	multe	adv.	w
few	malmulta	adj. small amount, countable or uncountable	w
few	plejmalmulto	n. a small segment of the whole	
so much	tiom multe	phr. it means soooo much	
most	plej multaj	phr.	
so little	tiom malmulte	phr.	
too much	tro multe	phr.	
]

_larĝ_ = [
broad	larĝa	adj. SHAPE	w
wide	larĝa	adj.	w
narrow	mallarĝa	adj.	w
]

_mister_ = [
mysteries	misteroj	n.	
mysterious	mistera	adj.	
]

_signif_ = [
means	signifis	v.tr has the meaning of	
significant	signifa	adj.	
meant	signifis	v.tr	
meaning	signifo	n. core idea, value, importance	w
mean	signifi	v.tr have the meaning of	
significance	signifo	n.	w
meant so much to you	signifis tiom multe por vi	phr.	
]

# -MEMOR-
_memor_ = [
recollect	rememori	v.tr	w
recollection	memoro	n.	w
recall	rememori	v.tr	w
remember	memori	v.tr put into memory	w
remember	rememori	v.tr recall from memory	w
in memory	memore	adv.	w
remind	memorigi	v.tr of something in the future	
remind	rememorigi	v.tr remind of something in the past	
memory	memoro	n.	w
remembered	memorita	adj.	
immemorial	nememorebla	adj.	w
]

_moment_ = [
momentary	momenta	adj.	w
momentarily	momente	adv. lasting a moment	w
for a moment	dum momento	phr.	
for an instant	por momento	phr.	
any moment	en iu ajn momento	phr. at any moment	w
moment	momento	n.	w
a moment	dum momento	phr. for a moment	
presently	ĉi-momente	adv.	
any minute now	ĉiun momenton nun	phr.	w
at this very moment	je ĉi tiu preciza momento	n.	
]

_krepusk_ = [
dusk	krepusko	n.	
dawn	matenkrepusko	n.	w
twilight	krepusko	n.	w
dusk	vesperkrepusko	n.	w
]

_fin_ = [
end	fino	n.	
ended	finiĝis	v.ntr	
endless	senfina	adj.	
final	fina	adj.	
finally	fine	adv.	
finally	finfine	adv.	
finish	fini	v.tr finish something or doing something	
last	fina	adj.	
ultimate	fina	adj.	
ultimate	finfina	adj.	
over	finita	adj.	w
very end	fina fino	phr.	
unfinished	nefinita	adj.	w
finished	fininta	adj.	w
infinitely	senfine	adv. endlessly, so long that no end is in sight	w
interminable	nefiniĝebla	adj.	w
interminably	nefiniĝeble	adv.	
unending	senfina	adj.	w
eventual	fina	adj.	
at last	finfine	adv.	
far end	malproksima fino	phr.	
to the end	ĝis la fino	n.	
]

_fru_ = [
late	malfrue	adv.	
later	malfrue	adv.	
shall be late	malfruos	v.ntr	
earliest	plej frua	adj.	
earlier	pli frua	adj.	
small hours	tre malfruaj horoj	phr.	
]

_lukr_ = [
earn	lukri	v.tr	
gain	lukri	v.tr	
win	lukri	v.tr	
]

_ŝpar_ = [
save	ŝpari	v.tr not use or spend	w
waste	malŝpari	v.tr	w
had saved	ŝparis	v.tr not used or spent	
]

_ĉar_ = [
carriage	ĉaro	n.	
cart	ĉaro	n.	
cartload	plenĉaro	n.	w
chariot	ĉaro	n.	w
charter	ĉarti	v.tr rent a vehicle	w
charter	ĉarto	n. legal charter	w
pram	infanĉareto	n.	
baby carriage	infanĉareto	n.	
wagoner	ĉaristo	n.	
]

# -VETUR-
_vetur_ = [
drive	veturigi	v.tr a vehicle	
chauffeur	veturigi	v.tr take someone somewhere by car	
take a drive	veturigi	v.tr take someone somewhere by vehicle	
travel	veturi	v.ntr to travel esp by vehicle	w
going for a drive	veturi	v.ntr	
]

_fier_ = [
proud	fiera	adj.	w
vanity	fiero	n.	w
]

_prav_ = [
are right	pravas	v.ntr	
right	prava	adj.	w
you’re right	vi pravas	v.ntr	w
wrong	malprava	adj.	w
]

_perfekt_ = [
perfect	perfekta	adj.	w
without flaw	perfekta	adj.	
defect	malperfektaĵo	n.	
flawless	perfekta	adj.	w
imperfection	malperfektaĵo	n.	w
perfectly	perfekte	adv.	w
]

_regul_ = [
regular	regula	adj. consistent	w
regulation	regulo	n.	w
uneven	neregula	adj.	w
regularly	regule	adv.	w
]

_pomp_ = [
pomp	pompo	n.	
pompous	pompa	adj.	w
]

_plonĝ_ = [
plunge	plonĝi	v.ntr	w
dive	plonĝi	v.ntr	w
]

_torent_ = [
torrent	torento	n.	w
rushing	torenta	adj. rushing as a rivulet might	w
rush	torenti	v.ntr like a rushing flow	w
]

_sek_ = [
dank	malseka	adj. wet	w
dry	seka	adj.	w
dryness	sekeco	n.	w
moisture	malsekeco	n.	w
moist	malseketa	adj.	w
moistened	malseketa	adj.	w
parched	sekigita	adj. WATER	w
damp	malseketa	adj.	w
moisture-stained	makulita de malsekeco	phr.	
]

_aplaŭd_ = [
applause	aplaŭdo	n.	w
]

_bild_ = [
image	bildo	n. ART	w
picture	bildigi	v.tr to present in the form of a  picture	w
picture	bildo	n. ART	
]

_prezent_ = [
image	prezento	n. ART	
representation	prezento	n. an image of ART	
performance	prezentado	n.	
represented	reprezentis	v.tr acted as representative, eg lawyer	
present	prezenti	v.tr	w
]

# -SON-
_son_ = [
sound	soni	v.ntr	w
soundless	sensona	adj.	w
reverberate	resonadi	v.tr.ntr 	w
unreverberate	neresonanta	adj. 	
reverberation	resonado	n. 	w
crash	kraŝa sono	n. crashing sound	w
]

# -SONOR-
_solor_ = [
clanged	sonoris	v.tr.ntr 	w
clang	sonoro	n. HEAR	w
bell	sonorilo	n. MUSIC	
peal	sonorilaro	n. set of bells MUSIC	w
ring out	elsonori	v.tr	w
peal	sonorado	n. ringing	w
]

# -KRAK-
_krak_ = [
crunch	kraki	v.ntr	w
clatter	kraki	v.ntr	w
crack	kraki	v.ntr	w
crackle	kraketi	v.ntr	w
]

# -TINT-
_tint_ = [
rattle	kraktinti	v.ntr make a sound like a chain	w
tinkling	tintado	n. a tinkling sound	w
tinkling	tintetanta	adj. tinking, like windchimes	w
]

# -KNAL-
_knal_ = [
bang	knali	v.ntr make a bang or snap sound	
]

# -AŬS-
_aŭskult_ = [
hark	aŭskultu	v.tr	w
listen	aŭskulti	v.tr	
listening	aŭskultante	adv.	
would listen	aŭskultus	v.tr	
auditor	aŭskultanto	n. listener	w
receiver	aŭskultilo	n.	w
overhear	subaŭskulti	v.tr very deliberately eavesdrop	w
overheard	subaŭskultita	adj.	
]

# -SILENT-
_silent_ = [
hush	silentu	v.ntr	w
silence	silento	n.	w
silent	silenta	adj.	
]

# -BRU-
_bru_ = [
drown	superbrui	v.ntr drown out and overpower noise	
noise	bruego	n.	
noise	bruo	n.	w
noiseless	senbrua	adj.	w
}

# -KLAK-
_klak_ = [
clank	klaki	v.ntr HEAR	w
clatter	klaki	v.ntr	w
click	klaki	v.ntr	w
clicking	klakado	n.	w
]

# -MILD-
_mild_ = [
mild	milda	adj.	w
soft	milda	adj. as a soft sound	w
gentle	milda	adj. more neutral than dolĉa	w
mellow	milda	adj.	w
softly	milde	adv.	w
relieve	mildigi	v.tr make gentler	w
softer	pli milda	adj.	
smoothly	milde	adv. figurative, speaking smoothly	
]

_asfalt_ = [
pitch	asfalto	n.	
asphalt	asfalto	n.	w
tar	asfalto	n.	
]

_ŝir_ = [
tear	ŝiri	v.tr	w
tear away	forŝiri	v.tr	
tearing	ŝiranta	adj.	
rent	disŝirata	adj. torn apart	
torn	ŝirita	adj.	
]

_blok_ = [
blocks	blokoj	n. block shaped chunks of material	
cloggy	blokema	adj.	w
clogged	blokita	adj.	w
]

_kurioz_ = [
curiously	kurioze	adv.	w
curious	kurioza	adj. exciting interest	w
funny	kurioza	adj. strange or curious	w
inscrutable	kurioza	adj.	
quaint	kurioza	adj.	w
strange	kurioza	adj.	
]

_ŝvel_ = [
swell	ŝveli	v.ntr	w
swell	ŝveligi	v.tr	w
be filled up	ŝveli	v.ntr	
bloat	ŝveli	v.ntr	w
bloated	ŝvela	adj.	
filled	ŝvela	adj.	
plump	ŝvela	adj.	
swollen	ŝvela	adj.	w
]

# -KON-
_kon_ = [
know	koni	v.tr be acquainted with	
knows	konas	v.tr	
knew	konis	v.tr	
have known	konis	v.tr	
had known	konis	v.tr	
known	konata	adj.	w
unknown	nekonata	adj.	
unknowing	nekonanta	adj.	
meet	ekkoni	v.tr meet for the first time	w
recognize	rekoni	v.tr	w
come to know	ekkoni	v.tr	
be acquainted with	koni	v.tr	
become acquainted with	ekkoni	v.tr	
acquaintance	konato	n.	w
worth knowing	koninda	adj.	
common knowledge	ĝenerale konata	phr.	w
familiar	konita	adj.	w
]

_kler_ = [
wise	klera	adj.	w
cultivated	klera	adj.	w
educated	klera	adj.	w
well informed	klera	adj.	w
ignorant	malklera	adj. uneducated	w
]

_marmor_ = [
marble	marmora	adj. made of marble	w
Elgin Marbles	Elginaj Marmoroj	n.proper Greek statuary in England
]

_sport_ = [
stadium	sportejo	n.	
gymnasium	sportejo	n. stadium	
]

_milit_ = [
war	milito	n. WAR	w
military	milita	adj. WAR	w
warrior	militisto	n.
]

_volv_ = [
wrapping up	envolvi	v.tr	
coiled	volvita	adj.	w
swathed	envolvita	adj. wrapped
]

_vest_ = [
garment	vesto	n. article of clothing	w
clothes	vesto	n. everything worn by a person	
dress	vesti	v.tr put clothing onto	w
get dressed	vestiĝi	v.ntr	w
headdress	kapvesto	n.	w
disguise	maskovesto	n.	w
]

_kolon_ = [
column	kolono	n. architectural	
colonnade	kolonaro	n.	w
]

# -KOLER-
_koler_ = [
anger	kolero	n.	w
made him angry	kolerigis lin	phr.	
be angry	koleri	v.tr.ntr	s
]

# -ĜAJ-
_gaj_ = [
dreary	malgaja	adj.	
sadly	malgaje	adv.	w
carefree	gaja	adj.	w
high spirited	gaja	adj.	
jolly	gaja	adj.	
merry	gaja	adj.	w
festive	gaja	adj.	
gayer	pli gaja	phr.	
gaily	gaje	adv.	w
merrily	gaje	adv.	w
jollity	gajeco	n.	w
mirth	gajeco	n.	w
jolly	gajega	adj.	
joy	gajo	n. gaiety, cheerfulness	w
cheerful	gajiga	adj. cheerfulness causing	
cheered	gajigis	v.tr made one cheerful	w
gaiety	gajeco	n.	w
]

_mantel_ = [
	mantelo	n.	
coat	mantelo	n.	
mantle	mantelo	n. coat	w
cloaked	mantelita	adj.	w
]

_palp_ = [
felt for	pripalpis	v.tr	w
tangible	palpebla	adj.	w
fumble	fuŝpalpi	v.tr	w
]

_ten_ = [
keep	teni	v.tr	w
hold	teni	v.tr	w
held	tenis	v.tr	w
held	tenita	adj.	
stand	elteni	v.tr endure	w
stand	sinteno	n. attitude	
point of view	sinteno	n.	
attitude	sinteno	n.	w
perspective	sinteno	n.	
manner	sintenado	n.	w
prevent	deteni	v.tr	
detain	deteni	v.tr	
retain	reteni	v.tr	
restraint	sindeteno	n.	w
kept	retenis	v.tr held back	
is behind	subtenas	v.tr	s
foothold	piedtenejo	n. place for placing the foot	w
posture	teniĝo	n.	w
hold out	antaŭteni	v.tr hold (something) out, extend it forward	w
holding out	antaŭtenante	adv. extending a thing in front of oneself	
unbearable	neeltenebla	adj.	w
]

_fajr_ = [
fire	fajro	n.	w
spark	fajrero	n.	w
fiery	fajra	adj. FIRE	w
campfire	tendarfajro	n.	w
camp fire	tendarfajro	n.	w
]

_flam_ = [
flame	flamo	n.	w
inflame	flamigi	v.tr raise flames in a burning thing, or excite strongly	
blazing	flamanta	adj.	w
aflame	flamanta	adj. FIRE	w
]

_kaŭz_ = [
cause	kaŭzi	v.tr	
caused	kaŭzis	v.tr	
]

_prov_ = [
try	provi	v.tr	
try out	provi	v.tr apply an object to its intended purpose	
test	provi	v.tr apply an object to its intended purpose	
experiment with	provi	v.tr apply an object to its intended purpose	
seek	provas	v.tr tries, attempts	w
tried	provis	v.tr	
attempt	provo	n.	w
sought	provis	v.tr ie tried	
put to the test	elprovi	v.tr apply an object to its intended purpose	w
]

_fal_ = [
fallen	falinta	adj. fallen because it once fell	
falls	falas	v.ntr	
drop	faligi	v.tr	
fell	falis	v.ntr	
crumbling	disfalanta	adj. lit. falling apart, more sudden and stuctural than diseriĝanta	
waterfall	akvofalo	n.	w
falls upon	alfalas sur	phr. eg an eye falls up what it looks at	
]

_ter_ = [
earth	tero	n.	
ground	tero	n.	w
earthly	tera	adj.	w
subterranean	subtera	adj.	w
unearthly	netera	adj.	w
bury	enterigi	v.tr	w
unearths	elterigas	v.tr	
underground	subtera	adj.	w
]

_ĵuri_ = [
jury	ĵurio	n.	
]

_ĵur_ = [
swear	ĵuri	v.tr SPEAK	w
sworn	ĵuris	v.tr SPEAK	w
swear	ĵuri	v.tr an oath	
swore	ĵuris	v.tr	
could have sworn	estus povinta ĵuri	phr.	
oath	ĵuro	n.	
vow	ĵuro	n.	w
]

_hejm_ = [
home	hejmo	n.	w
home	hejme	adv. at home	
home	hejmen	adv.toward home	
homewards	hejmen	adv.	W
]

# -FENEST-
_fenestr_ = [
window	fenestro	n.	W
bank of windows	aro da fenestroj	n.	
windowless	senfenestra	adj.	
shop window	montrofenestro	n. 	w
]

_spez_ = [
spend	elspezi	v.tr	
pay out	elspezi	v.tr	
turnover	spezi	v.tr to turnover (money)	
]

_riĉ_ = [
rich	riĉa	adj.	w
poor	malriĉa	adj.	w
richness	riĉeco	n.	w
poverty	malriĉeco	n.	w
wealth	riĉeco	n.	w
]

_eben_ = [
flat	ebena	adj. not bumpy	w
plane	ebeno	n.	w
plain	ebenaĵo	n.	w
]

_plaĉ_ = [
be pleasing to	plaĉi	v.ntr	
is pleasing to	plaĉi	v.ntr ie 'like' very colloquial	
pleasant	plaĉa	adj.	w
pleased	plaĉita	adj.	w
please	plaĉi	v.ntr	
]

_part_ = [
part	parto	n.	w
partial	parta	adj.	
most	plejparto	n. the majority from among countable things	w
partly	parte	adv.	w
largely	grandparte	adv.	w
much	granda parto	phr.	
]

# -KURAC-
_kurac_ = [
doctor	kuracisto	n. physician	w
heal	kuraci	v.tr	w
physician	kuracisto	n.	w
treat	kuraci	v.tr an illness or wound	w
treatment	kuracado	n.	w
cure	kuraco	n. something that cures health	w
]

_permes_ = [
allow	permesi	v.tr	w
let	permesi	v.tr permit	w
forbid	malpermesi	v.tr	w
permission	permeso	n.	w
leave	forpermeso	n. leave of absence	w
forbidden	malpermesita	adj.	w
]

_intern_ = [
inner	interna	adj.	w
interiors	internoj	n.	w
innermost	plej interna	adj.	w
inside	interne	adv. 	w
]

_ekvilibr_ = [
balance	ekvilibro	n. equilibrium	w
balance	ekvilibri	v.ntr be in equilibrium	w
balance	ekvilibrigi	v.tr bring into balance	w
unbalanced	malekvilibra	adj.	w
]

_ventr_ = [
belly	ventro	n.	w
paunch	ventro	n.	w
prone	surventre	adv.	w
]

_delikat_ = [
delicate	delikata	adj.	w
exquisitely	delikate	adv.	W
exquisite	delikata	adj.	w
]

_skem_ = [
scheme	skemo	n. theoretical simplified image	w
pattern	skemo	n. pattern as in a scheme, layout, or structure	w
]

_decid_ = [
decide	decidi	v.tr	w
decision	decido	n.	
resolution	decido	n. decision	w
resolution	decideco	n. property of determination	w
made his mind up	decidiĝis	v.ntr	
made up his mind	decidis	v.tr	
undecided	nedecidite	adv. while being undecided	
]

_tabl_ = [
table	tablo	n. on which to place things	w
desk	skribtablo	n.	w
sales counter	vendotablo	n.	s
sales table	vendotablo	n.	s
]

_fraz_ = [
sentence	frazo	n.	w
phrase	frazero	n.	
phrase	frazo	n.	w
]

_propr_ = [
own	propra	adj.	w
of his own	propran	adj.	
property	propreaĵo	n. special characteristic	
appropriate	alproprigi	v.tr take someone's stuff	w
peculiarity	propreco	n.	w
]

_afekt_ = [
affect	afekti	v.tr pretend, put on airs	w
affected	afekta	adj. faked	w
unaffected	senafekta	adj. not faked	w
]

_rifuz_ = [
refusal	rifuzo	n.	w
refuse	rifuzi	v.tr	w
spurn	malestime rifuzi	phr.	w
]

_pik_ = [
stab	piko	n.	w
prick	piki	v.tr	w
sting	piki	v.tr like a bee	w
stung	pikite	adv.	
]

_stabil_ = [
stability	stabileco	n.	w
stabilize	stabiligi	v.tr	w
stable	stabila	adj.	
balance	stabiligi	v.tr balance something, stabilize	
stability	stabileco	n.	w
shaky	nestabila	adj.	w
]

_anticip_ = [
anticipation	anticipo	n.	w
apprehension	anticipado	n.	
expectation	anticipio	n.	w
anticipatory	anticipa	adj.	w
would expect	anticipus	v.tr	w
]

_ĉiel_ = [
sky	ĉielo	n.	w
outdoor	subĉiela	adj.	
heaven	ĉielo	n. likely preceded by 'la'	
]

_sink_ = [
sink	sinki	v.ntr	w
sank	sinkis	v.ntr	
had gone down	estis sinkinta	phr. had drowned when the ship sunk	
]

_pen_ = [
effort	peno	n.	
strive	peni	v.ntr exert effort to achieve a result	
try	peni	v.ntr strive, exert effort to achieve a result	
effort	penado	n.	w
make an effort	peni	v.ntr exert effort to achieve a result	
with an effort	pene	adv.	s
]

_etendi_ = [
spread	etendi	v.tr extend and spread out	
outstretched	etendita	adj. extended	
were craned	etendiĝis	v.ntr became extended	
stretches out	etendas	v.tr	w
lingeringly	eletendite	adv.	w
reach	etendo	n. extension	w
ranged	etendis	v.tr	w
stretched	etendis	v.tr	
reaching	etendiĝante	adv. extending to	
reaches for	etendas la manon al	phr.w	w
]

_ŝvabr_ = [
wetmop	ŝvabri	v.tr	
wetmop	ŝvabrilo	n.	
mopping up	ŝvabro	n. a mopping up	
mop	ŝvabri	v.tr to wetmop	
]

_erar_ = [
fault	eraro	n.	w
mistake	eraro	n.	w
accurate	senerara	adj. without errors	
are mistaken	eraras	v.ntr	w
mistaken	erara	adj.	w
]

_lingv_ = [
language	lingvo	n.	w
tongue	lingvo	n. fig 'language'	w
bilingual	dulingva	adj.	w
]

_anonc_ = [
unannounced	neanoncita	adj.	w
]

_protrud_ = [
protruding	protruda	adj.	
protuberant	protruda	adj.	w
]

_trud_ = [
intrusion	entrudiĝo	n.	w
]

_urĝ_ = [
urgent	urĝa	adj.	w
urge	urĝi	v.tr urge with emphasis on time constraint	w
]

_rekt_ = [
straight	rekte	adv. along the shortest linear path	
straighten up	rektiĝi	v.ntr	w
upright	rekte	adv.	w
erect	rekte	adv.	w
]

_epok_ = [
age	epoko	n. era or epoch	w
Middle Ages	Mezepoko	n.	w
in its day	en sia propra epoko	phr.	
medieval	mezepoka	adj. 	w
]

_spion_ = [
spies	spionoj	n.	w
spy	spiono	n.	w
]

_tren_ = [
drag	treni	v.tr	w
drag	treni	v.tr	w
shuffle	treniĝi	v.ntr move oneself in a dragging fashion	w
]

_rok_ = [
rocky	roka	adj.	w
rocks	rokoj	n. not to be confused with stones	w
bed-rock	bazroko	n. 	w
]

_respekt_ = [
respect	respekto	n.	w
deference	respektego	n.	w
reverently	respektege	adv.	w
reverence	respektego	n. 	w
self-respect	memrespekto	n.	w

]

_ŝarĝ_ = [
laden	ŝarĝita	adj.	w
burden	ŝarĝo	n.	w
]

_ampleks_ = [
bulked so largely	faris sin tiel ampleksa	phr. lit. 'made himself so comprehensive'	
bulky	ampleksa	adj.	w
ample	ampleksa	adj.	w
gross	ampleksa	adj. bulky	
large	ampleksa	adj. bulky	
all-embracing	tute ampleksa	phr.	
]

_kapabl_ = [
ability	kapablo	n.	w
unable	nekapabla	adj.	w
]

_kramp_ = [
clamp	krampo	n.	w
bracket	krampo	n.	
parenthesis	krampo	n. rondaj() rektaj[] angulaj<> kurbaj{}	
]

_origin_ = [
origin	origino	n.	
originate	origini	v.ntr	w
begin	origini	v.ntr	
]

_pet_ = [
ask	peti	v.tr request, ask (someone) for something	w
beg	petegi	v.tr beg someone or something TALK	w
implore	petegi	v.tr implore someone or something	w
supplicating	petege	adv.	w
apologise	pardonpeti	v.tr	w
apology	pardonpeto	n.	w
don't ask	ne petu	phr.	w
imploringly	petege	adv.	w
]

_sklav_ = [
slave	sklavo	n.	w
slavish	sklaveca	adj.	w
]

_freŝ_ = [
freshly	freŝe	adv.	w
fresh	freŝa	adj.	w
freshness	freŝeco	n.	w
]

_petol_ = [
act up	petoli	v.ntr	w
flirt	petoli	v.ntr	
frolic	petoli	v.ntr	
goof around	petoli	v.ntr	w
naughty	petola	adj.	w
play	petoli	v.ntr frolic	
scampering	petolanta	adj.	w
prank	petolo	n.	
practical joke	petolo	n.	
mischievously	petole	adv.	
teasingly	petole	adv.	w
]

_impon_ = [
awesome	impona	adj. impressive	
impressive	impona	adj.	w
]

_incit_ = [
incite	inciti	v.tr	
agitate	inciti	v.tr	w
stir up	inciti	v.tr	w
]

_dolĉ_ = [
sweet	dolĉa	adj. when of water, fresh not salty	w
gentle	dolĉa	adj. more intense than milda	
sweeter	pli dolĉa	adj.	
]

_ŝlos_ = [
key	ŝlosilo	n.	w
latchkey	klinka ŝlosilo	n.	w
confine	enŝlosi	v.tr lock up	w
]

_tord_ = [
twisting	tordante	adv.	
writhing	tordiĝanta	adj.	w
distort	distordi	v.tr	w
distortion	distordo	n.	w
distort	distordi	v.tr	w
]

_kaŭr_ = [
lurk	kaŭri	v.ntr	w
squatted	kaŭris	v.ntr	
squat	kaŭra	adj. low and wide as if squatting	w
]

_marŝ_ = [
trudge	marŝo	n.	w
stride	marŝi	v.ntr
plodded	marŝis	v.ntr	
stalking	marŝadi	v.ntr	
stalked out	elmarŝis	v.ntr	
stalking	ĉaseme marŝi	phr.	
filed	marŝis kolumne	phr. marched in a single file	
]

_polv_ = [
dust	polvo	n.	
dusty	polva	adj.	
]

_danc_ = [
dance	danci	v.tr.ntr to dance	w
dance	danco	n. a dance move, like ‘the hustle’	w
dancer	dancanto	n. one who is dancing	w
dancer	dancisto	n. professional dancer	w
dancing	dancado	n.	
square dance	kvadrila danco	n.	w
dancing-girl	dancistino	n. female professional dancer	w
partner	kundancantino	n. female dance partner	
]

_liver_ = [
deliver	liveri	v,tr	w
delivered	liverota	adj. delivered in the future	
]

_lant_ = [
linger	lanti	v.ntr	w
dawdle	lanti	v.ntr spend doing something unimportant or acting slowly	w
]

_prokrast_ = [
delay	prokrasti	v.tr	w
delay	prokrasto	n.	w
delay	prokrasto	n.	w
without delay	senprokraste	adv.	
]

_normal_ = [
normal	normala	adj.	w
defect	nenormalaĵo	n.	
abnormality	nenormalaĵo	n.	w
it’s only natural	estas nur normala	phr.	
]

_ambici_ = [
ambition	ambicio	n.	w
ambitious	ambicia	adj.	w
]

_proced_ = [
procedure	procedo	n.	w
process	procedo	n. as an industrial process	w
procedure	proceduro	n. customary or legal procedure	w
]

_destin_ = [
destinations	destinoj	n.	
destined	destinita	adj.	
destiny	destino	n.	
]

_dign_ = [
dignity	digno	n.	
with dignity	digne	adv.	
resentfully	indigne	adv.	w
]

_ben_ = [
blessing	beno	n.	w
bless	beni	v.tr	w
curse	malbeni	v.tr	w
accursed	malbenita	adj.	w
accursed	sub malbeno	phr.	w
]

_benjet_ = [
doughnut	benjeto	n. 	w
donut	benjeto	n. 	w
beignet	benjeto	n. 	w
]

_frat_ = [
brother	frato	n. FAMILY	w
sister	fratino	n. incl nuns	
]

_atest_ = [
affirm	atesti	v.tr	w
statement	atesto	n. testimony	w
bear witness	atesti	v.tr	w
witness	atesti	v,tr	w
]

_fortik_ = [
hardy	fortika	adj.	w
stronghold	fortikaĵo	n.	
]

_svelt_ = [
slim	svelta	adj.	w
slender	svelta	adj.	w
]

_korp_ = [
body	korpo	n.	w
bodily	korpa	adj.	w
physical	korpa	adj. bodily, use 'fizika' when technical	w
physically	korpe	adv. bodily, use 'fizike' when technical	s
make corporeal	enkorpigi	v.tr	w
disembodied	nekorpa	adj.  	w
disembodied	senkorpa	adj.  	w
]

_korpulent_ = [
fat	korpulenta	adj. of people	w
portly	korpulenta	adj.	w
corpulent	korpulenta	adj.	w
]

_trink_ = [
drink	trinki	v.tr incl. alcohol in moderation	w
drank	trinkis	v.tr	w
drink	trinkaĵo	n.	w
potation	trinkaĵo	n.	w
urinate	maltrinki	v.ntr	w
pee	maltrinki	v.ntr	w
bar	trinkejo	n.	w
]

_absurd_ = [
absurd	absurda	adj.	w
absurdly	absurde	adv.	w
]

_krust_ = [
crisp	krusta	adj.	
crust	krusto	n.	w
encrusted	enkrustita	adj.	w
scab	krusto	n.	
]

# -SAN-
_san_ = [
healthy	sana	adj.	w
unhealthy	malsana	adj.	w
sanatorium	sanatorio	n. residential rehab, ≠hospitalo	
hospital	malsanulejo	n.	w
sickened	malsanigita	adj.	w
sickly	malsanema	adj.	w
malady	malsano	n.	w
be cured	por esti resanigita	phr. lit. for the purpose of being restored to health	
well	sana	adj. healthy	w
would make ill	malsanigus	v.tr	
ill	malsana	adj. not healthy	w
recovery	resaniĝo	n. recovery of health	w
sick	malsana	adj.	w
ailing	malsana	adj. not healthy	
ailment	malsaneto	n.	w
getting ill	malsaniĝi	v.ntr	
disease	malsano	n.	w
have recovered	resaniĝis	v.ntr	
]

# NERVES
_nerv_ = [
bundle of nerves	fasko de nervoj	n. a Nervous Nellie	w
nervous	nerva	adj.  related to anatomical nerves	w
nerves	nervoj	n. figurative nervous status	w
]

# -VUND-
_vund_ = [
hurt	vundi	v.tr wound	w
injure	vundi	v.tr	w
injured	vundita	adj.	
wound	vundi	v.tr	w
]

_boben_ = [
reel	bobeno	n.	w
coil	bobeno	n.	w
]

_naŭz_ = [
noisome	naŭza	adj. disgusting	w
nauseous	naŭza	adj.	w
revolting	naŭza	adj.	w
]

_ŝnur_ = [
rope	ŝnuro	n.	w
string	ŝnureto	n.	w
unleash	deŝnuri	v.tr	w
]

_kre_ = [
make	krei	v.tr create	w
create	krei	v.tr	w
creation	kreitaro	n. ie biblical, all that was created in the world	w
]

_murmur_ = [
mumbled	murmuris	v.tr	w
murmur	murmuro	n.	w
murmurs	murmuri	v.tr	w
]

_estim_ = [
contemptuous	malestima	adj.	w
held in high repute	estimata	adj.	
scorn	malestimo	n.	w
]

_instig_ = [
urge	instigi	v.tr urge less intent on time than intent	w
]

_insult_ = [
abuse	insulti	v.tr.ntr	w
yell at	insulti	v.tr.ntr	
revile	insulti	v.tr.ntr	w
shot	insulto	n. insult	w
]

_rast_ = [
raking out	rasto	n. a raking out	
comb up	rasti	v.tr	
rake	rastilo	n.	
rake up	rasti	v.tr	
]

_kur_ = [
run	kuri	v.ntr with the feet	
run after	postkuri	v.tr	
run though	trakuri	v.tr	
coursing	trakuri	v.tr flow through	
ran	kuris	v.ntr	
rush	kuregi	v.ntr	
]

_febr_ = [
fever	febro	n.	w
feverish	febra	adj.	w
]

_absorb_ = [
absorb	absorbi	v.tr occupy the mind esclusively	w
absorb	absorbiĝi	v.ntr become absorbed 	w
absorbed	absorbita	adj. 	w
absorption	absorbiĝo	n. 	w
absorption	absorbiteco	n. 	w
]

_ban_ = [
bath	bano	n.	w
bathe	bani	v.tr bathe an other	w
bathe	baniĝi	v.ntr bathe oneself	w
light bath	lum'bano	phr. light bath	
]

_ŝpruc_ = [
splashed	ŝprucinta	adj.	
gush	ŝpruci	v.ntr	w
splashed	ŝprucis	v.ntr	w
]

_salt_ = [
leap	salto	n.	w
leaped	saltis	v.ntr	
sprang in	ensaltis	v.ntr	
]

_scen_ = [
scene	sceno	n.	
stage	scenejo	n.	w
setting	scenejo	n.	w
]

_firm_ = [
business	firmo	n.	
enterprise	firmo	n. 	w
fast	firme	adv. firmly	w
firm	firma	adj.	
steadily	firme	adv.	w
firmly	firme	adv.	w
firm	firmo	n. 	
]

# -ĜOJ-
_ĝoj_ = [
with joy	ĝoje	adv. 	
sad	malĝoja	adj.	
dismal	senĝoja	adj. joyless	w
sadness	malĝojo	n.	w
joy	ĝojo	n. feeling of rejoicing	w
glad	ĝoja	adj.	w
joyously	ĝoje	adv.	w
delight	ĝojo	n.	
delighted	ĝoje	adv.	
happily	ĝoje	adv.	w
looked forward	antaŭĝojis pri	phr.	
looked forward to	antaŭĝojitaj	phr. as in anticipated	
make happy	ĝojigi	v.tr	s
Gaudeamus Omnes	Ni Ĉiuj Ĝoju	phr. Latin “Let us all Rejoice,” Latin title of a chant	
]

# -KOMPAT-
_kompat_ = [
compassion	kompato	n.	w
forgiveness	kompato	n.	w
pitying	kompatanta	adj.	
poor	kompatinda	adj. deserving pity	w
sympathy	kompato	n.	w
merciful	kompatema	adj.	
piteous	kompatinda	adj.	w
mercilessly	senkompate	adv.	w
]

_dispon_ = [
have access to	disponi	v.tr.ntr	
have available	disponi	v.tr.ntr	
afford	disponigi	v.tr.ntr make available	
]

_amuz_ = [
amuse	amuzi	v.tr	w
amusement	amuzo	n. something amusing	w
amusing	amuza	adj.	w
hilarity	amuzego	n.	w
funny	amuza	adj. amusing	w
be entertained	amuziĝi	v.ntr	
entertaining	amuza	adj.	w
pastime	amuzaĵo	n.	
amusement	amuziĝo	n.	w
]

# -SIMPAT-
_simpati_ = [
agreeable	simpatia	adj. of people	
compatible	simpatia	adj. of people	
sympathetic	simpatia	adj.	
sympathise	simpatii	v.tr	
sympathy	simpatio	n.	
would sympathise	simpatius	v.tr	
]

# -SOPIR-
_sopir_ = [
pine	sopiri	v.tr yearn for	
yearning	sopiro	n.	
longing	sopiro	n.	w
longing	sopirinta	adj. condition of having longed for	
would not pine	ne sopirus	phr.	
miss	sopiri	v.tr yearn for	
]

_kvazaŭ_ = [
as	kvazaŭ	conj. as if	
as if	kvazaŭ	conj.	
as if it were	kvazaŭ	conj.	
as though	kvazaŭ	conj.	
seemingly	kvazaŭ	conj.	
quasi	kvazaŭ	conj.	w
like	kvazaŭ	conj. as if	
that	kvazaŭ	conj. as if	
]

_kvankam_ = [
while	kvankam	conj. although	w
although	kvankam	conj. shows cause or motive	w
though	kvankam	conj. shows cause or motive	
]

_kant_ = [
sing	kanti	v.tr.ntr	w
sang	kantis	v.tr.ntr	
waits	karolaj kantistoj	n. carol singers	
singsong	kvazaŭ kanti	phr.	w
]

# -VOK-
_vok_ = [
call	alvoki	v.tr to summon	
call	alvoko	n. a calling to, as in a summons, or profession	
call	voko	n. the words of one who calls	
call	voki	v.tr call to	
will call	vokos	v.tr call to	
calling	alvoko	n. a calling to, as in a summons, or profession	w
calling	vokanta	adj.	
]

_seĝ_ = [
seat	seĝo	n.chair	w
armchair	brakseĝo	n. FURNITURE	w
commode	truseĝo	n.	
toilet seat	truseĝo	n.	w
]

_eduk_ = [
breed	eduki	v.tr	
bring up	eduki	v.tr	
cultivate	eduki	v.tr a talent	
domesticate	eduki	v.tr	
educate	eduki	v.tr	
rear	eduki	v.tr	
tame	eduki	v.tr	
train	eduki	v.tr	
]

_alarm_ = [
alarm	alarmo	n.	w
alarmed	alarmite	adv.	w
]

_ted_ = [
annoy	tedi	v.tr	w
be boring	tedi	v.tr to someone	
]

_rand_ = [
edge	rando	n.	
rim	rando	n.	w
bordered	randita	adj. around the edges
on edge	kvazaŭ sur rando	phr. idiom	w	
]

_gast_ = [
hospitable	gastama	adj.	w
host	gastiganto	n.	w
inn	gastejo	n.	w
gasthaus	gastejo	n. German, Inn	w
]

_plump_ = [
inelegant	plumpa	adj.	
gauche	plumpa	adj. CLOTHES	
awkward	plumpa	adj.	w
]

_bul_ = [
ball	bulo	n. blob of stuff	
loaf	bulo	n. blob of stuff	
lump	bulo	n. blob of stuff	
]

_ŝveb_ = [
loom	ŝvebi	v.ntr hover	w
hover	ŝvebi	v.ntr	
]

_rajt_ = [
may	rajti	v.tr are entitled to	
by rights	rajte	adv.	
cannot	ne rajtas	v.tr are not allowed to	
may I not	ĉu mi ne rajtas	phr.	
by rights	laŭrajte	adv.	w
]

_elekt_ = [
choose	elekti	v.tr	
chose	elektis	v.tr	
elect	elekti	v.tr	
pick out	elekti	v.tr	
select	elekti	v.tr	
choice	elekto	n.	w
have chosen	estas elektinta	phr.	
chosen	elektinta	adj. a state of having chosen in the past	
]

_selekt_ = [
breed	selekti	v.tr breed selectively	
select	selekti	v.tr	
]

_sam_ = [
different	malsama	adj.	
just the same	same	adv. in the same way	
same	sama	adj.	
]

_amar_ = [
bitterly	amare	adv.	
bitter	amara	adj. literal or figurative	w
]

# -FELIĈ-
_feliĉ_ = [
happily	feliĉe	adv.	w
unhappy	malfeliĉa	adj.	w
happiness	feliĉo	n.	w
happy	feliĉa	adj.	w
]

_muel_ = [
grind	mueli	v.tr	w
mill	muelilo	n.	w
mill-wheel	rado de muelilo	n.	w
]

_bagatel_ = [
trifle	bagatelo	n.	w
trivial	bagatela	adj.	w
]

_pergamen_ = [
parchment	pergameno	n.	w
]

# -ĈAGREN-
_ĉagren_ = [
sadden	ĉagreni	v.tr	w
annoy	ĉagreni	v.tr	w
exasperate	ĉagreni	v.tr cause displeasure	w
frustrate	ĉagreni	v.tr	.
vex	ĉagreni	v.tr	w
ail	ĉagreni	v.tr	w
]

# -ANGOR-
_angor_ = [
anxiety	angoro	n. severe anxiety, level-3	w
agony	angoro	n.	
anguish	angoro	n.	w
distraught	angora	adj. 	w
]

# -TENT-
_tent_ = [
tempt	tenti	v.tr	w
tempted	tentata	adj. was in a state of temptation	
temptingly	tentante	adv.	
]

_kontent_ = [
pleased	kontenta	adj.	w
satisfactorily	kontentige	adv.	w
satisfy	kontentigi	v.tr	w
]

# -ĜU-
_ĝu_ = [
enjoy	ĝui	v.tr	w
enjoying	ĝuanta	adj.	
enjoyment	ĝuo	n.	w
]

# -SUFER-
_sufer_ = [
suffering	sufero	n.	w
suffers	suferas	v.ntr	
suffering	suferanta	adj.	w
]

_vizaĝ_ = [
face	vizaĝo	n. front of head	w
facial	vizaĝa	adj.	w
on his face	en lia vizaĝo	phr.	w
efface	senvizaĝigi	v.tr to make a thing have no face	
]

_ĉerp_ = [
exhaust	elĉerpi	v.tr use up completely	w
died out	elĉerpiĝis	v.ntr	w
]

_hont_ = [
ashamed	honta	adj.	w
shameless	senhonta	adj.	w
am ashamed	hontas	v.tr	w
shamefully	hontinde	adv.	
]

_ekstaz_ = [
ecstatic	ekstaza	adj.	w
ecstasy	ekstazo	n.	w
beside himself	ekstaza	adj. ecstatic	w
]

_anksi_ = [
anxiety	anksio	n. moderate anxiety, level-2	w
anxious	anksia	adj.	w
]

_envi_ = [
envy	envii	v.tr	w
envy	envio	n.	w
]

# -PLEZUR-
_plezur_ = [
pleasure	plezuro	n.	w
displeasure	malplezuro	n.	w
with pleasure	plezure	adv.	w
]

# - STUPOR-
_stupor_ = [
dazed	stuporita	adj.	w
stupefied	stuporite	adv.	w
]

_ekscit_ = [
thrill	eksciti	v.tr  	w
thrill	ekscito	n.	w
excitement	eksciteco	n.	w
roused	ekscitite	adv.	
excitedly	ekscitite	adv.	w
]

_gust_ = [
taste	gusti	v.ntr 	w
delicious	bongusta	adj.	w
tasty	bongusta	adj.	w
]

_trakt_ = [
treat	trakti	v.tr to treat a subject	w
treated	traktita	adj.	
negotiate	intertrakti	v.tr	w
bargain	intertrakti	v.ntr negotiate	w
deal with	trakti	v.tr	w
]

_numer_ = [
digit	numero	n.	
number	numeri	v.tr to number	
number	numero	n.	
cipher	numero	n.	
unnumbered	nenumerita	adj.	w
copy	numero	n. of a magazine	
edition	numero	n. of a magazine	
]

_ĵurnal_ = [
newspaper	ĵurnalo	n.	w
paper	ĵurnalo	n. newspaper	w
]

_kultur_ = [
cultivate	kulturi	v.tr	
develop	kulturi	v.tr	
raise	kulturi	v.tr	
fallowed fields	senkulturejo	n.	w
]

_leg_ = [
read	legi	v.tr	w
reader	leganto	n.	w
unread	nelegita	adj.	w
]

_por_ = [
pore	poro	n.	
porous	pora	adj.	w
tiny hole	poro	n.	
]

_strikt_ = [
tight	strikta	adj.	
tight	strikte	adv.	
close-fitting	strikta	adj.	w
]

_glav_ = [
sword	glavo	n.	w
foil	skerma glavo	n. fencing sword	w
]

_naĝ_ = [
swim	naĝi	v.ntr	w
swam	naĝis	v.ntr	
]

_spit_ = [
spite	spiti	v.tr openly defy	w
in defiance of	spite de	adv.	
order to spite	spite de	adv.	
]

_ali_ = [
other	alia	adj.	w
otherwise	alie	adv. under an other condition	w
others	aliuloj	n.	w
to one another	unu al la alia	phr.	s
another	alia	adj.	w
any other	alia	adj.	s
else	alie	adv.	
other	alio	n.	w
]

_ŝanc_ = [
lucky	bonŝanca	adj.	w
chance	ŝanco	n.	w
]

_absolut_ = [
utter	absoluta	adj.	w
stark	absoluta	adj.	w
utterly	absolute	adv.	w
]

_krisp_ = [
wavy	krispa	adj.	w
crinkled	krispa	adj.	w
]

_argan_ = [
crane	argano	n. machine only	w
drilling hoist	argano	n.	
hoist	argano	n. for drilling	w
]

_glaci_ = [
ice	glacio	n.	w
icy	glacie	adv.	W
icily	glacie	adv.	w
]

_ir_ = [
go	iri	v.ntr	w
goes	iras	v.ntr	
have gone	iris	v.ntr	
went	iris	v.ntr	
got out	eliris	v.ntr	
exit	elirejo	n.	w
to go out	eliri	v.ntr	w
exit	eliri	v.ntr	w
get out	eliri	v.ntr	w
goes out	eliras	v.ntr	w
came out	eliris	v.ntr	
went out	eliris	v.ntr	w
cropping out	eliranta	adj.	
go back	retroiri	v.ntr	
gone	irinta	adj.	w
gone out	foririnta	adj.	
went about	estis irantaj	phr.	
went through	trairis	v.tr	
moves off	deiras	v.ntr departs	w
move away	foriri	v.ntr	w
gone	foririnta	adj.	w
approaching	alirante	adv.	w
cross	transiri	v.tr	w
beat it	foriru	v.ntr go away	w
traverse	transiri	v.tr	w
goes off	foriras	v.ntr	w
step inside	eniri	v.ntr	
enter	eniri	v.tr	
enters	eniras	v.tr	w
entrance	enirejo	n.	w
crossing	transirante	adv.	
crept	ŝteliris	v.ntr	
left	foriris	v.ntr	
off he went	li subite ekiris	phr.	
coming down	malsupreniro	n.	
creep out	elŝteliri	v.ntr	
creeping	ŝteliranta	adj.	w
creeps	ŝteliri	v.ntr	w
creeps up	alŝteliras	v.ntr	
has crept	estas ŝtelirinta	phr.	
went about	ĉirkaŭe iris	phr. use 'iri' if they weren't going around something	
advancement	antaŭeniro	n.	w
go through with	trairi	v.tr	w
]

_elektr_ = [
electric	elektra	adj.	w
electricity	elektro	n.	w
]

_aparat_ = [
apparatus	aparato	n.	w
instrument	aparato	n. device incl telephone	w
device	aparato	n.	
telephone outfit	telefonaparato	n. antiquated telephone equipment set	
radio	radioaparato	n. as a communications instrument	
]

_brul_ = [
burning	brulanta	adj.	w
burn	bruli	v.ntr	w
burn	bruligi	v.tr	w
light	ekbruligi	v.tr start a fire	w
burned	bruligita	adj.	
seared	bruligita	adj.	w
ablaze	brulanta	adj. FIRE	w
]

_kalkul_ = [
calculate	kalkuli	v.tr.ntr	
count	kalkuli	v.tr.ntr 	w
count up	kalkuli	v.tr.ntr 	
count on	kalkuli	v.tr.ntr 	
uncounted	nekalkulita	adj. 	w
incalculably	nekalkuleble	adv. 	w
countless	nekalkulita	adj. 	
depend on	kalkuli	v.tr.ntr	
]

_alt_ = [
tall	alta	adj. SHAPE	w
height	alteco	n.	w
high	alta	adj.	w
high up	alte	adv.	w
higher	pli alta	adj.	
highest	plej alta	adj.	
low	malalta	adj.	w
lowness	malalteco	n.	w
]

_lojal_ = [
loyal	lojala	adj.
is loyal	lojalas	v.ntr	
loyalty	lojaleco	n.	w

]

_virt_ = [
vice	malvirto	n.	w
sin	malvirto	n.	
]

_sankt_ = [
holy	sankta	adj.	w
sacred	sankta	adj.	w
shrine	sanktejo	n.	w
unsanctified	nesanktita	adj.	w
]

_vaz_ = [
vessel	vazo	n.	
vase	florvazo	n.	
container	vazo	n.	
]

_ramp_ = [
crawling	rampa	adj.	
crawl	rampi	v.ntr	w
crawl out	elrampi	v.ntr	
crawl in	enrampi	v.ntr	
]

_avid_ = [
crave	avidi	v.tr	w
avid	avida	adj. 	w
eagerly	avide	adv.	w
]

_vel_ = [
sail	velo	n. maritime	w
sailing	velanta	adj.	
]

_tendenc_ = [
bias	tendenco	n.	w
biased	tendenca	adj.	w
inclination	tendenco	n.	
tendency	tendenco	n.	w
]

_torĉ_ = [
torch	torĉo	n.	
flambeaux	torĉoj	n. French	w
]

_foli_ = [
sheet	folio	n. sheet of paper	w
foliage	foliaro	n. all the leaves on a plant	w
pamphlet	faldfolio	n.	w
brochure	faldfolio	n.	w
]

_gazet_ = [
paper	gazeto	n. newspaper	
magazine	gazeto	n.	
periodical	gazeto	n. incl magazines and newspapers	
newspaper	gazeto	n.	
press	gazetaro	n.	
media	gazetaro	n. the press	
]

_bezon_ = [
need	bezoni	v.tr	w
require	bezoni	v.tr	w
]

_rivel_ = [
reveal	riveli	v.tr	
revealing	rivela	adj.	
]

_risk_ = [
risk	riski	v.tr to take a risk	
risk	risko	n. possibility of failure	
]

_servic_ = [
service	servico	n. as in a service of china	w
set	servico	n. as in a service of china	
]

_fanfaron_ = [
show off	fanfaroni	v.ntr	
brag	fanfaroni	v.ntr	
put on the dog	fanfaroni	v.ntr	w
]

_radi_ = [
radiant	radia	adj.	
radiation	radiado	n. as in radiotherapy radioactivity	
radio	radio	n. as a communications medium	
ray	radio	n.	
spoke	radio	n. of a wheel or the analogous part of a radially symmetrical object	w
radiant	radianta	adj. as in a radiant face	w
beam	radio	n.	
violet rays	violaj radioj	phr.	
moonbeam	lunradio	n.	w
]

# -HEL-
_hel_ = [
dark	malhelo	n.	w
brightly	hele	adv.	
dark	malhela	adj. dimly lit, color having little white	
lights began to rise	lumoj komencis heliĝi	phr.	w
lights to be turned up	lumoj heligu	phr. a wish for more light	
]

_damaĝ_ = [
harm	damaĝo	n. 	w
damage	damaĝo	n.	w
]

_best_ = [
beast	besto	n.	w
vermin	bestetaĉoj	n.	w
pest	damaĝbesto	n. household beasty eg rat 	
totem-beast	totem-besto	n.	w
]

_dec_ = [
decent	deca	adj.	
indecent	maldeca	adj.	
]

_detru_ = [
destroy	detrui	v.tr	
destruction	detruo	n.	
obliterated	detruita	adj.	w
]

_obstin_ = [
obdurate	obstina	adj.	w
obstinate	obstina	adj.	w
recalcitrant	obstina	adj.	w
]

_komb_ = [
brush	kombi	v.tr through something esp hair	
comb	kombi	v.tr through something esp hair	w
comb	kombilo	n.	w
combing out	kombo	n. a combing out	
]

_murd_ = [
murder	murdi	v.tr	w
murderous	murdema	adj.	w
]

_ŝov_ = [
shove	ŝovi	v.tr push slidingly	w
slipping	ŝoviĝo	n.	w
wriggle	flankenŝovi	v.tr	
]

_bronz_ = [
bronze	bronzo	n. 	w
brazen	bronza	adj. 	w
]

_grimp_ = [
climb	grimpi	v.ntr	w
scramble	krab-grimpi	v.ntr	w
]

_aĝ_ = [
older	pli aĝa	adj.	
what age	kiom aĝa	phr.	
eldest	plej aĝa	phr. AGE	w
age	aĝo	n. time in existence	
at the age of	en la aĝo de	phr.	
aged	aĝinta	adj. having aged	w
thirty years of age	aĝis tridek jarojn	phr.	
adult	plenaĝulo	n.	
grown-up	plenaĝulo	n.	
]

_vir_ = [
man	viro	n.	
men	viroj	n.	
woman	virino	n.	w
women	virinoj	n.	w
half woman	duonvirino	n.	
]

_disput_ = [
debate	disputi	v.ntr TALK	
argument	disputo	n.	w
disagreement	disputo	n.	
]

_distanc_ = [
distance	distanco	n.	
short distance	mallonga distanco	n. a short distance	
at arm’s length	je brakodistanco	phr.	w
]

_emerit_ = [
retired person	emerito	n.	
retiree	emerito	n.	
emerita	emerito	n.	
emeritus	emerito	n.	
]

# -KLAR-
_klar_ = [
clear	klara	adj.	w
clearer	pli klara	adj.	
plain	klara	adj.	
distinctly	klare	adv.
plainly	klare	adv.	
clearly	klare	adv.	
explain	klarigi	v.tr	w
account for	klarigi	v.tr	w
indistinct	malklara	adj.	
vague	malklara	adj. confused, indistinguishable	
dimly	malklare	adv. not clearly as in seeing dimly	w
vaguely	malklare	adv.	
blur	neklaraĵo	n. a thing hard to distinguish	
unexplainable	neklarigebla	adj.	w
inexplicably	neklarigeble	adv.  	w
inexplicable	neklarigebla	adj.	w
]

_apertur_ = [
aperture	aperturo	n.	w
orifice	aperturo	n.	w
]

# -APER-
_aper_ = [
disappeared	malaperis	v.ntr	w
vanish	malaperi	v.ntr	w
disappearance	malapero	n.	w
peep	ekaperi	v.ntr	w
breaking	ekaperanta	adj. in the sense of suddenly appearing	
]

# -BLIND-
_blind_ = [
blind	blinda	adj. unable to see	w
blinded you	blindigis vin	phr.	
blindly	blinde	adv.	
blinds	blindigas	v.tr	
dazzling	blindiga	adj.	w
]

_land_ = [
country	lando	n.	w
lands	landoj	n. countries or some abstraction thereof	
abroad	eksterlande	adv.	w
foreign	eksterlanda	adj.	w
counties	graflandoj	n.	
county	graflando	n. territory ruled by a count	w
midland counties	mezlandaj graflandoj	phr.	
]

_vent_ = [
wind	vento	n.	
gale	ventego	n. WEATHER	w
]

_ŝmir_ = [
streak	ŝmiraĵo	n.	w
smear	ŝmiraĵo	n. esp lipstick ART	w
]

_kontrast_ = [
contrast	kontrasto	n. 	
contrast	kontrasti	v.tr.ntr stand out in relief from another ART	
]

_vart_ = [
tend	varti	v.tr	w
take care of	varti	v.tr take care of in a nurturing way	
raise	varti	v.tr	
baby-sit	varti	v.tr	w
]

_kvartal_ = [
district	kvartalo	n. a district of a city 	w
quarter	kvartalo	n. district	w
]

_delir_ = [
delirium	deliro	n.	w
be delirious	deliri	v.ntr	
delirious	delira	adj.	w
rave	deliri	v.ntr	w
]

_reputaci_ = [
reputation	reputacio	n.	w
repute	reputacio	n.	w
]

_ripoz_ = [
rest	ripozi	v.ntr	w
rest	ripozo	n. the thing one has while resting, a rest	w
restless	senripoza	adj.	
repose	ripozi	v.ntr take a rest	w
]

_sign_ = [
sign	signo	n. indication	w
token	signo	n. a sign, a thing that signififies	w
motion	signi	v.ntr signal by eg a hand motion	w
beckon	mansigni	v.ntr	w
footstep	piedsigno	n. footprint	w
omen	antaŭsigno	n.	w
]

_perturb_ = [
disturb	perturbi	v.tr	w
unperturbed	senperturba	adj.	w
]

_monoton_ = [
monotony	monotoneco	n.	w
monotonous	monotona	adj.	w
]

_neces_ = [
necessary	necesa	adj.	w
unnecessary	nenecesa	adj.	w
]

_farm_ = [
farm	farmi	v.tr to farm (land) as a tenant	
farm	farmo	n. rental farm land	
farmer	farmisto	n. tenant farmer	
]

_konker_ = [
conqueror	konkeranto	n. conquering at present WAR	w
conqueror	konkerinto	n. conquered in the past WAR	w
conquer	konkeri	v.tr obtain by WAR rule by force	w
unconquerable	nekonkerebla	adj.	w
]

_pokal_ = [
grail	pokalo	n. stemmed glass	
stemmed glass	pokalo	n.	
trophy	pokalo	n.	
trophy cup	pokalo	n. SPORT	
]

_manĝ_ = [
eat	manĝi	v.tr	w
food	manĝaĵo	n.	w
take supper	vespermanĝi	v.ntr	
necrophagous	mortmanĝa	adj.	w
lunch hour	tagmanĝa horo	phr.	W
]

_ŝanĝ_ = [
change	ŝanĝi	v.tr	
alteration	ŝanĝiĝo	n.	w
alter	ŝanĝiĝi	v.ntr	w
]

_respond_ = [
answer	respondi	v.tr (response is accusative)	w
correspond	respondi	v.tr	
in answer	responde	adv.	
line up	respondi	v.tr	
reply	respondi	v.tr	
respond	respondi	v.tr	w
responsibility	respondeco	n.	w
countersign	pasvorta respondo	n. 	w
take responsibility	respondeci	v.ntr (+pri)	
]

_korespond_ = [
correspond	korespondi	v.ntr exchange letters or other messages	
exchange letters	korespondi	v.ntr	
exchange messages	korespondi	v.ntr	
]

_fuĝ_ = [
flee	fuĝi	v.ntr run away	w
fled	fuĝis	v.ntr flee from danger	
defect	transfuĝi	v.ntr hide out	w
hide out	transfuĝi	v.ntr	
]

_hid_ = [
hideous	hida	adj.	w
hideously	hide	adv.	w
]

_defi_ = [
defiant	defia	adj.	w
defies	defias	v.tr	w
challenge	defii	v.tr	w
]

_rol_ = [
play	roli	v.tr as a performance	w
perform	roli	v.tr as an actor	
played a part	ludis rolon	phr.	
]

_bien_ = [
property	bieno	n.	
farm	bieno	n.	
estate	bieno	n. real rural estate	
family farm	etbieno	n.	
landed estate	grandbieno	n.	
]

_arb_ = [
tree	arbo	n.	w
sapling	arbido	n.	w
upas-tree	upasarbo	n. aka antiaris	w
forest	arbaro	n.	w
grove	arbareto	n.	w
woodland	arbaro	n.	w
]

_flor_ = [
flower	floro	n.	w
bloom	floro	n.	w
bloom	flori	v.ntr	w
flower	flori	v.ntr	w
]

_simil_ = [
similar	simila	adj.	w
suchlike	simila	adj. having similar properties	w
]

_renkont_ = [
encounter	renkonti	v.tr	
meet	renkontas	v.tr	
meet	renkonti	v.tr meet someone	
meet	renkontiĝi	v.ntr meet each other	
meeting	renkontiĝo	n. encounter ie the act of meeting	
met	renkontiĝis	v.ntr did meet each other	
run into	renkonti	v.tr someone	w
saw	renkontis	v.tr met with	
meet	renkontiĝi	v.ntr meet each other	w
encountered	renkontita	adj.	
met	renkontis	v.tr did meet	
]

_krud_ = [
rudely	krude	adv. crudely	w
crudity	krudeco	n.	w
stark	krude	adv. raw	w
]

_implic_ = [
imply	implici	v.tr	
implication	implicaĵo	n. that which is logically implied	
]

_ofert_ = [
offer	oferti	v.tr offer something for a price	
offer	oferto	n. not used for gifts	
]

_ofer_ = [
offer	oferi	v.tr offer as a sacrifice	
offer	oferi	v.tr to a guest	
sacrifice	oferi	v.tr	
sacrifice	ofero	n.	w
has sacrificed	oferis	v.tr	
]

_konserv_ = [
keep	konservi	v.tr not lose	
kept	konservita	adj.	
preserve	konservi	v.tr	
preserved	konservita	adj.	
retain	konservi	v.tr	
]

_impet_ = [
impetus	impeto	n.	w
rush	impeti	v.ntr throw oneself forward forcefully	w
]

_precip_ = [
particularly	precipe	adv.	w
above all	precipe	adv.	w
especially	precipe	adv.	w
]

_kompens_ = [
offset	kompensi	v.tr	
compensate for	kompensi	v.tr	
make up for	kompensi	v.tr	w
]

_mez_ = [
medium	meza	adj.	
middle	meza	adj.	w
midway	meze de	adv.	w
amidst	meze de	adv.	w
noon	tagmezo	n.	w
at noon	je tagmezo	phr. TIME	s
at noon	tagmeze	adv.	s
afternoon	posttagmezo	n.	w
in the afternoon	posttagmeze	adv.	s
midnight	noktomezo	n.	w
]

_spac_ = [
space	spaco	n.	
room	spaco	n. ie space eg 'make room'	
interval	interspaco	n.	
ultimate space	prae finfina spaco	n.	
]

_konekt_ = [
connection	konekto	n.	w
connect	konekti	v.tr eg an electrical circuit	w
]

_pioĉ_ = [
pick	pioĉi	v.tr work with a pick	
pick	pioĉo	n. a pick	wv
]

_stamf_ [
stamp	stamfi	v.ntr	w
]

_konversaci_ = [
talk	konversacio	n. informal talk	w
conversation	konversacio	n.	w
converse	konversacii	v.ntr	w
]

_ŝtel_ = [
rob	ŝteli	v.tr	w
steal	ŝteli	v.tr	w
would steal	ŝtelus	v.tr	
crept in	enŝteliĝis	v.ntr	w
stealthily	ŝtele	adv.	w
steal	alŝteliĝi	v.ntr sneak up	w
]

_drink_ = [
drink	drinki	v.tr.ntr drink something alcoholic to excess	w
guzzle	drinki	v.tr.ntr drink something alcoholic to excess	w
booze it up	drinki	v.tr.ntr drink something alcoholic to excess	w
]

_plad_ = [
platter	plado	n.	w
serving plate	plado	n.	w
]

_mord_ = [
bite	mordi	v.tr	w
morsel	mordaĵo	n.	w
]

_speci_ = [
species	specio	n. biological species	
]

_kamen_ = [
chimney	kameno	n.	w
chimney	kamentubo	n.	w
]

_bret_ = [
shelf	breto	n.	w
set of shelves	bretaro	n.	
mantelpiece	kamenbreto	n.	w
shelve	enbretigi	v.tr	w
]

_ekzerc_ = [
drill	ekzerci	v.tr to drill or exercise somebody	
exercise	ekzerci	v.tr practice; to drill or exercise somebody	
exercise	ekzerco	n. an exercise	
practice	ekzerci	v.tr practice, practicer in accusative eg 'ekzercas sin al pieco'	
practice	ekzerciĝi	v.ntr as the piano	
practice	sin ekzerci	v.tr as the piano	
]

_kar_ = [
precious	kara	adj.	
dear	kara	adj. incl expensive	
darling	karulino	n.	w
dear one	karulino	n.	s
dearest	plej kara	adj.	
expensive	kara	adj.	
]

_demon_ = [
daemon	demono	n.	w
demon	demono	n.	w
demoniac	demona	adj. demonic	w
daemoniac	demona	adj. demonic	w
]

_hant_ = [
haunt	hanti	v.tr	w
haunter	hantanto	n. 	w
]

_agnosk_ = [
would recognise	agnoskus	v.tr	
recognise	agnoski	v.tr	
acknowledge	agnoski	v.tr	w
recognize	agnoski	v.tr by official declaration	
]

_furioz_ = [
rage	furiozi	v.ntr 	
raging	furiozi	v.ntr	
fury	furiozo	n. 	w
]

_akir_ = [
obtain	akiri	v.tr get	w
acquiring	akirante	adv.	w
recover	reakiri	v.tr eg a mood	w
]

_sens_ = [
felt	sensis	v.tr physical sensation	
sense	senso	n. of touch hearing etc	w
]

_serv_ = [
served	servis	v.tr.ntr	
servant	servisto	n.	
at your service	je via servo	phr.	w
service	diservo	n. religious service	w
]

_implik_ = [
involve	impliki	v.tr	
entangle	impliki	v.tr	
implicate	impliki	v.tr	w
entangled	implikita	adj.	w
]

_ceter_ = [
the rest	la cetero	n.	w
remainder	cetero	n.	
moreover	cetere	adv.	w
]

_inspir_ = [
inspired	inspirita	adj.	w
inspiration	inspiro	n.	w
inspiration	inspiriteco	n.	w
inspiration	inspiro	n.	w
]

_spirit_ = [
spirit	spirito	n.	
wit	spirito	n.	
spiritual	spirita	adj.	w
spiritually	spirite	adv.	w
]

_ador_ = [
worship	adori	v.tr	w
is worshipping	adoras	v.tr	
worshipper	adoranto	n.	w
adorable	adorinda	adj.	
]

_kondamn_ = [
sentence	kondamno	n. in court	w
verdict	kondamno	n. in court	
doomed	kondamnita	adj.	w
condemned	kondamnita	adj.	w
]

_ego_ = [
selfish	egoisma	adj.	w
selfishness	egoismo	n.	w
egoist	egoisto	n.	w
]

_agrabl_ = [
nasty	malagrabla	adj. disagreeable	w
]

_paŭz_ = [
pause	paŭzi	v.ntr	w
slight pause	Iometa paŭzo	phr.	
]

_soci_ = [
social	socia	adj.	
society	socio	n.	
]

_solen_ = [
solemn	solena	adj.	
solemnly	solene	adv.	w
insolently	insolente	adv.	w
]

_konstru_ = [
build	konstrui	v.tr	w
built	konstruis	v.tr	
builder	konstruisto	n. contruction worker	
building	konstruaĵo	n.	w
edifice	konstruaĵo	n.	w
]

# -KONSCI-
_konsci_ = [
conscious	konscii	v.tr.ntr (+pri) be conscious of	
consciousness	konscio	n.	
aware	konscia	adj.	w
oblivious	nekonscia	adj.	w
oblivion	nekonscio	n.	w
realise	konscii	v.tr.ntr (+pri) to be aware	
consciousness	konscio	n.	w
become conscious of	konsciiĝis pri	phr.	
conscience	konscienco	n.	w
unselfconscious	nememkonscia	adj.	w
]

# -PERCEP-
_percept_ = [
note	percepti	v.tr notice	w
notice	percepti	v.tr	w
perceive	percepti	v.tr	w
perceiving	perceptante	adv.	
]

_poet_ = [
poet	poeto	n.	w
minor poet	negrava poeto	phr. poet who is not one of 'the greats'	
]

_revu_ = [
magazine	revuo	n.	w
journal	revuo	n.	w
technical journal	revuo	n.	s
]

_sonĝ_ = [
dream	sonĝo	n. dream had while sleeping	
dreamily	sonĝe	adv. as if dreaming in sleep	w
]

_bal_ = [
dance	balo	n. an gathering at which one dances	
boy and girl dance	balo por gejunuloj	phr.	
]

_dekliv_ = [
downhill	deklive	adv.	w
slope	deklivo	n. non-horizontal ground	w
]

_fend_ = [
fissure	fendo	n.	w
rift	fendo	n. crack	w
fissure	fendo	n. 	w
chasm	fendego	n. 	w
]

# DESERT
_dezert_ = [
desert	dezerto	n.	w
deserted	dezerta	adj.like a desert or uninhabited	w
waste	dezerto	n. a desert	w
desertion	dezerteco	n.	
desolate	dezerteca	adj.	w
]

_urb_ = [
city	urbo	n.	w
suburban	suburba	adj.	w
capital	ĉefurbo	n.	w
]

_mezur_ = [
measurement	mezuro	n. act of measuring SHAPE	w
immeasurably	nemezureble	adv.	w
]

_mojos_ = [
fashionable	mojosa	adj. non-PIV	
cool	mojosa	adj. fashionable non-PIV	
admirable	mojosa	adj. non-PIV	
]

_nigr_ = [
black	nigra	adj.	w
blackened	nigrita	adj.	w
blackness	nigreco	n.	w
jetty	karbonigra	adj.  jet-black	w
depressing	nigra	adj. sentiments attitudes	
all the blacker	des pli nigra	phr.	
ominous	nigra	adj. sentiments attitudes	
]

_manier_ = [
manner	maniero	n.	w
otherwise	aliemaniere	adv. in a different manner	w
way	maniero kiel	phr. manner in which	
in every respect	ĉia'maniere	adv.	
]

_adiaŭ_ = [
farewell	adiaŭ	interj.	w
take leave of	adiaŭi	v.tr	
say farewell	adiaŭi	v.tr	
leave-taking	adiaŭo	n.	w
]

_pint_ = [
peak	pinto	n.	w
point	pinto	n. tip of sword or needle	
on tiptoe	piedpinte	adv.	w
]

_ricev_ = [
receive	ricevi	v.tr	w
radio	radioricevilo	n. as a communications instrument	
obtain	ricevi	v.tr receive	
]

_vulgar_ = [
ordinary	vulgara	adj.	
colloquial	vulgara	adj.	w
common	vulgara	adj. ordinarily used	w
lay	vulgara	adj.	
popular	vulgara	adj.	
]

_taks_ = [
assess	taksi	v.tr	
calculate	taksi	v.tr	
estimate	taksi	v.tr	
evaluate	taksi	v.tr	
judge	taksi	v.tr esp when applied to people	
surcharge	taksi	v.tr	w
set a maximum legal price for	taksi	v.tr	
]

_taksi_ = [
taxi	taksii	v.ntr	
taxi	taksio	n.	w
taxicab	taksio	n.	w
]

_ŝofor_ = [
drive	ŝofori	v.tr.ntr	w
chauffeur	ŝofori	v.tr.ntr take soemone somewhere by car	w
chauffeur	ŝoforo	n.	w
]

_bus_ = [
take a bus	trafi buson	phr.	s
bus	buso	n.	
]

_strat_ = [
street	strato	n.	w
alley	strateto	n.	w
]

_ombr_ = [
shadow	ombro	n.	w
shade	ombro	n.	w
shadowed	ombris	v.tr	
shading	ombrado	n. a shadow which has been cast	w
]

_diabl_ = [
devil	diablo	n.	
fiendish	diabla	adj.	w
fiend	diablo	n. devil	w
]

_kap_ = [
head	kapo	n.	w
nod	kapjesi	v.tr signifies 'yes'	w
nod	kapnei	v.tr signifies 'no'	w
nod	kapindiki	v.tr signifies a direction	w
clearheaded	klarkapa	adj.	w
]

_sun_ = [
sun	suno	n.	w
sunrise	sunleviĝo	n.	w
sunset	sunsubiro	n.	w
]

_fresk_ = [
fresco	fresko	n. ART	w
frescoed	freskita	adj. ART	w
]

_kapitan_ = [
captain	kapitano	n.	w
]

_guberni_ = [
governor	guberniestro	n.	w
]

_muĝ_ = [
roar	muĝi	v.ntr	w
]

_suspekt_ = [
suspect	suspekti	v.tr	
suspicion	suspekto	n.	w
]

_vizi_ = [
vision	vizio	n. visual hallucination or revelation	w
television	televizio	n. communication medium	w
Great One of Vision	Granda Viziulo	phr. essentially a a visionary or seer	
]

_nobl_ = [
nobly	noble	adv.	w
nobler	pli nobla	phr.	
noblest	plej nobla	phr.	
]

_glit_ = [
slid	glitis	v.ntr	
skimmed	glitis laŭ	phr. slid along	w
slip out	elgliti	v.ntr either drop accidentally, speak unintentionally, or sneak out unnoticed	w
slippery	glitiga	adj. tending to cause one to slip	w
]

_ripar_ = [
mend	ripari	v.tr	w
]

_modern_ = [
modern	moderna	adj.	w
old-fashioned	malmoderna	adj. 	w
old-time	malmoderna	adj. 	w
]

_oportun_ = [
convenient	oportuna	adj.	w
opportunities	oportunaĵoj	n.	
]

_konsil_ = [
advice	konsilo	n.	w
advised	konsilis	v.tr	
counsel	konsili	v.tr	w
]

_konsili_ = [
council	konsilio	n. leading body of people	w
]

_krim_ = [
crime	krimo	n.	w
criminal	krima	adj. like a criminal	w
]

_rikolt_ = [
reap	rikolti	v.tr	w
harvest	rikolto	n.	w
]

_humor_ = [
humor	humoro	n. emotional state or body fluid	w
mood	humoro	n.	w
]

_enu_ = [
bored	enua	adj.	w
dull	enuiga	adj. boring	w
]

_genu_ = [
knee	genuo	n.	w
kneel	genui	v.ntr	w
knelt	genuis	v.ntr	w
]

_entuziasm_ = [
enthusiasm	entuziasmo	n.	w
eagerness	entuziasmo	n.	w
enthusiastically	entuziasme	adv.	w
with enthusiasm	entuziasme	adv.	w
]

_iluzi_ = [
illusion	iluzio	n.	w
cynical	seniluzia	adj. without illusions	
skeptical	seniluzia	adj. without illusions	
disappointment	seniluziiĝo	n.	
disappointed	seniluziigita	adj.	w
]

_opini_ = [
deem	opinii	v.tr	w
opinion	opinio	n.	w
]

_ret_ = [
web-site	retejo	n.	w
net	reto	n.	w
network	reto	n.	w
internet	reto	n. 	w
]

_difin_ = [
definite	difinita	adj.	w
resolution	difino	n. pixels per inch	w
]

_akurat_ = [
on time	akurata	adj.	w
prompt	akurata	adj.	w
punctual	akurata	adj.	w
]

_lig_ = [
bind	ligi	v.tr	w
linked	ligita	adj.	w
connected	ligitaj	adj.	
would bind	ligus	v.tr	
bound together	kunligita	adj.	
]

_ĉen_ = [
chain	ĉeno	n.	w
string	signoĉeno	n. group of alpha-numeric characters COMPUTER	w
]

_timid_ = [
shyly	timide	adv.	w
]

_simpl_ = [
simply	simple	adv.	w
simple	simpla	adj. plain	w
grew simple	simpliĝis	v.ntr became simple	
]

_anhel_ = [
gasp	anhelo	n. breathe with difficulty and noisily	w
gasp	anheleri	v.tr a unit of gasping labored breathing	w
pant	anhelo	n. breathe with difficulty and noisily	w
]

_medicin_ = [
medical	medicina	adj.	w
medicine	medicino	n. the theory or practice of medicine	
]

_herb_ = [
grass	herbo	n. one plant or blade of grass	
weed	herbaĉo	n.	w
herbage	herbaro	n. grasses as a collection	w
meadow	herbejo	n.	w
herb	drogherbo	n. medicinal	w
herb	aromherbo	n. seasoning	w
weed-choked	herbaĉe strangolita	phr.	
]

_krev_ = [
burst	krevi	v.ntr	w
explode	krevi	v.ntr	
pop apart	krevi	v.ntr	
]

_figur_ = [
figure	figuro	n.	w
became transfigured	transfiguriĝis	v.ntr	
]

_fosforesk_ = [
phosphorescent	fosforeska	adj.	w
phosphorescence	fosforesko	n.	w
]

_mok_ = [
mocking	moke	adv. mockingly	
mockery	mokataĵo	n.	
mockingly	moke	adv.	w
]

_centr_ = [
center	centro	n.	w
centre	centro	n.	
]

_koncentr_ = [
concentrate	koncentriĝi	v.ntr	w
concentrated	koncentrita	adj.	w	
]

_plan_ = [
planning	planante	adv. in the act of making a plan	
compass	plani	v.tr make a plan for	w
design	plano	n. plan of action (less formal, more improvised)	w
]

_facil_ = [
easily	facile	adv.	w
difficult	malfacila	adj.	w
is hard	malfacilas	v.ntr	s
in the lurch	en malfacila situacio	phr.	w
make harder	plimalfaciligi	v.tr	w
don't make it harder	ne plimalfaciligu ĝin	phr.	
]

_salon_ = [
parlour	salono	n.	w
ballroom	bala salono	n.	w
]

_apartament_ = [
apartment	apartamento	n.	w
flat	apartamento	n.	w
]

_moŝt_ = [
highness	moŝto	n. title for royalty	
grace	moŝto	n. title for royalty	
majesty	moŝto	n. title for royalty	w
]

_gvardi_ = [
guard	gvardiano	n. a single guardsman	
guard	gvardio	n. eg 'Swiss Guard' or 'Red Guard'	
]

_politik_ = [
political	politika	adj.	w
politics	politiko	n.	w
policy	politiko	n.	
]

_tabul_ = [
board	tabulo	n. for games	w
tablet	tabulo	n.	
plank	tabulo	n.	
target	celtabulo	n. in archery	w
]

_juĝ_ = [
judge	juĝi	v.tr	w
]

_konspir_ = [
conspiracy	konspiro	n.	w
]

_eskort_ = [
escort	eskorto	n. group of people	w
unattended	seneskorte	adv.	W
]

_kort_ = [
courtyard	korto	n. 	w
patio	korto	n.	w
]

_fasad_ = [
façade	fasado	n.	w
facade	fasado	n.	w
]

_hal_ = [
large room	halo	n.	
hall	halo	n.	w
]

_tegment_ = [
roof	tegmento	n.	
rafters	tegmenta trabaro	n.	w
]

_ŝton_ = [
pebble	ŝtoneto	n.	w
rocks	ŝtonoj	n.	
stone	ŝtona	adj. made of stone	w
thing of stone	ŝtonaĵo	n.	s
stone	ŝtono	n.	w
stony	ŝtona	adj.	w
petrified	ŝtonigita	adj. figurative, as if having been turned to stone	w
]

_ĉifon_ = [
rags	ĉifonaĵoj	n. worn torn part of a garment	
rags	ĉifonoj	n.	
]

_rob_ = [
dress	robo	n.	w
robe	robo	n.	w
enrobed	enrobita	adj. 	w
]

_teks_ = [
weave	teksi	v.tr	w
textile	teksajo	n.	w
loom	teksilo	n.	w
]

_jak_ = [
jacket	jako	n. as in bed jacket, ski jacket, smoking jacket etc; usually for a man	
jacket	jaketo	n. book jacket or baby’s jacket	
jacket	ĵaketo	n. (1) morning coat; (2) a woman’s suit jacket.; (3) little ĵako.	
]

_ŝtof_ = [
cloth	ŝtofo	n.	w
fabric	ŝtofo	n. 	w
]

_potenc_ = [
power	potenco	n.	w
mighty	potenca	adj. powerful	w
]

_proviant_ = [
provisions	provianto	n. normally food	w
cater	provianti	v.tr	w
caterer	proviantanto	n.	w
]

_sat_ = [
starve	malsati	v.ntr	w
propitiate	satigi	v.tr	w
hungry	malsata	adj.	w
hungering	malsatante	adv.	
]

_pag_ = [
pay	pagi	v.tr amount paid is in the accusative	w
paid	pagis	v.tr	s
rent payment	lupago	n.	w
underpaid	nesufiĉe pagata	phr.	w
]

_prunt_ = [
lend	prunti	v.tr	w
borrow	prunti	v.tr 	w
]

_fakultat_ = [
college	fakultato	n. of a university	
faculty	fakultato	n. university faculty	w
department	fakultato	n. of a university	
division	fakultato	n. of a university	
]

_fakult_ = [
capability	fakulto	n.	w
faculty	fakulto	n. capability	w
]

_ornam_ = [
decorated	ornamita	adj.	w
decoration	ornamaĵo	n.	w
ornament	ornamaĵo	n. thing that adorns	w
ornate	ornamita	adj.	w
]

_eter_ = [
aether	etero	n. material comprising empty space	w
ether	etero	n. material comprising empty space, organnic anesthetic	w
]

_etern_ = [
eternity	eterno	n.	w
always	eterne	adv. eternally	
forever and ever	eterne kaj eterne	phr.	
eternal	eterna	adj.	w
forever	por eterno	phr. for all future time	
for all time	por eterno	phr.	
forever and ever	por eterno kaj eterne	phr.	w
for eternity	eterne	adv.	s
]

_horloĝ_ = [
clock	horloĝo	n.	w
watch	brakhorloĝo	n. wrist clock	w
watch	poŝhorloĝo	n. pocket watch	w
]

_ĝen_ = [
hold back	sin ĝeni	v.tr	
trouble oneself	sin ĝeni	v.tr	
]

_sving_ = [
wave	svingi	v.tr	
swung	svingiĝis	v.ntr	
one fell swoop	per unuopa svingo	phr. one fell swoop	w
swung back open	resvingita malferme	phr.	
]

_lud_ = [
play	ludi	v.tr.ntr	
plays	ludas	v.tr.ntr	
game	ludo	n.	w
]

_aventur_ = [
adventure	aventuro	n.	w
]

_kanvas_ = [
canvas	kanvaso	n.	w
]

_ekster_ = [
outside	ekstere	adv.	w
outside	ekstero	n.	w
outer	ekstera	adj.	w
]

_ordinar_ = [
ordinary	ordinara	adj.	w
commonplace	ordinara	adj.	w
extraordinarily	eksterordinare	adv.	w
extraordinary	eksterordinara	adj.	w
peculiar	eksterordinara	adj.	w
]

_nud_ = [
bare	nuda	adj.	w
]

_patron_ = [
patron	patrono	n.	w
]

_atelier_ = [
studio	ateliero	n. artist's studio	w
]

_studi_ = [
studio	studio	n. space for performing and recording	w
]

_ekzamen_ = [
examine	ekzameni	v.tr	w
examination	ekzameno	n. detailed exam incl medical exam	
inquiry	ekzameno	n.	
inspection	ekzameno	n. thorough inspection	
]

_intens_ = [
intense	intensa	adj.	w
keen	intensa	adj.	w
intently	intense	adv.	w
]

_prepar_ = [
prepare	prepari	v.tr	w
preparation	preparo	n.	
unprepared	senprepara	adj.	w
without preparation	senprepare	adv.	s
]

_honest_ = [
honest	honesta	adj.	W
racket	malhonestaĵo	n.	w
shakedown	malhonestaĵo	n.	w
]

_vend_ = [
shop	vendejo	n.	w
market	vendejo	n. shop	w
flower-seller	flor’vendisto	n.
]

_sentenc_ = [
maxim	sentenco	n.	
saying	sentenco	n. pithy saying	w
]

_esplor_ = [
research	esploro	n.	w
explore	esplori	v.tr	w
explorer	esploranto	n.	w
]

_tuk_ = [
apron	antaŭtuko	n.	w
]

_pipr_ = [
pepper	pipro	n.	w
peppercorn	pipro	n.	w
off-color joke	pipro	n.	
]

_blag_ = [
joke	blagi	v.tr to put somebody on	
joke	blago	n. joking fib	
]

_blasfem_ = [
swear	blasfemi	v.tr blaspheme; cuss	
cuss	blasfemi	v.tr blaspheme	w
blaspheme	blasfemi	v.tr	w
]

_damn_ = [
damned	damninda	adj. damnable, generic expletive	w
damnable	damninda	adj. generic expletive	w
]

_di_ = [
god	dio	n.	
divine	dia	adj.	
divine	dieca	adj. less literal	w
deity	diaĵo	n.	
goddess	diino	n.	w
]

_antikv_ = [
antique	antikva	adj.	w
ancient	pra-antikva	adj. 	w
ancient	antikva	adj. 	w
]

_primitiv_ = [
primitive	primitiva	adj.	
primitive-looking	ŝajne primitiva	adj.	
]

_legend_ = [
legend	legendo	n. old story 	w
legendary	legenda	adj.	w
]

_grotesk_ = [
grotesqueness	groteskeco	n.	w
grotesquely	groteske	adv.	w
grotesqueness	groteskeco	n.	w
]

_art_ = [
art	arto	n. 	w
artistic	arta	adj. 	w
artist	artisto	n. 	w
]

_renvers_ = [
tip	renversi	v.tr overturn	w
turned upside down	renversiĝis	v.ntr	
]

_polic_ = [
police	polico	n. as an institution	w
police officer	policano	n.	
police officer	policisto	n.	
policemen’s	policanajn	adj.	
]

_plat_ = [
plate	plato	n. eg plate glass	w
flat	plata	adj.	
slab	plato	n.	w
palm	manplato	n. as in the palm of the hand	w
]

_baston_ = [
stick	bastono	n.	w
crutches	lambastonoj	n.	w
wand	magia bastoneto	n. magic wand, small magical stick	
]

_gir_ = [
whirl	giri	v.ntr to be whirling	w
spun	giris	v.ntr	
whirl	girigi	v.tr whirl a dance partner	
]

_front_ = [
face	alfronti	v.tr face adversity	w
face	fronti	v.ntr to face someone	
]

_broŝur_ [
paperback book	broŝuro	n.	w
pamphlet	broŝureto	n.	w
booklet	broŝureto	n.	w
unbound pages	broŝuro	n.	
]

_depresi_ = [ 
depression	depresio	n. clinical depression	w
]

_feston_ = [
festoon	festono	n.	w
]

_preleg_ = [
speech	prelego	n. lecture	w
lecture	prelego	n.	w
]

_fak_ = [
branch	fako	n. of science, art	
department	fako	n. including university departments	
compartment	fako	n. section, compartment (of a drawer or box)	
specialty	fako	n. professional specialty	
]

_instru_ = [
teach	instrui	v.tr someone or something	w
teach how	instrui	v.tr to do something	
taught	instruis	v.tr	
shall teach	instruos	v.tr	
]

_klas_ = [
class	klaso	n. incl class in school made up of students	w
sort	klaso	n.	
species	klaso	n. non-biological	
]

_kolor_ = [
color	koloro	n.	w
colour	koloro	n.	w
colouring	kolorigo	n. the color which has been applied	w
coloring	koloriĝo	n.	w
discolored	diskolora	adj.	w
roseate	rozkolora	adj.	w
in pink	rozkolore	adv. wearing pink clothing	s
]

_ruĝ_ = [
red	ruĝa	adj.	w
redly	ruĝe	adv. 	w
blush	ruĝiĝi	v.ntr redden, incl. by shame	w
flush	ruĝiĝo	n.	w
]

_pal_ = [
pale	pala	adj.	w
pale	paliĝi	v.ntr become pale	w
wan	pala	adj.	w
pallid	pala	adj.	w
]

_blank_ = [
white	blanka	adj.	w
whiteness	blankeco	n.	w
]

_griz_ = [
grey	griza	adj.	w
gray	griza	adj.	w
hoary	aĝe griza	adj.	w
]

_plafon_ = [
ceiling	plafono	n.	
low-ceiled	malalte-plafona	adj.	w
]

_ĉambr_ = [
room	ĉambro	n.	w
suite	ĉambraro	n.	w
barroom	trinkĉambro	n.	w
]

_tend_ = [
tent	tendo	n. cloth building	w
camp	tendaro	n. group of tents	w
]

_kaduk_ = [
dilapidated	kaduka	adj.	w
decrepitude	kadukiĝo	n.	w
decay	kadukiĝi	v.ntr	w
]

_lim_ = [
limitation	limo	n.	w
illimitable	senlima	adj.	w
]

_nov_ = [
older	pli malnova	adj.	
lay person	novulo	n.	
]

_horizontal_ = [
level	horizontala	adj.	w
horizontal	horizontala	adj. 	w
]

_brid_ = [
unbridle	senbridigi	v.tr	w
abandon	senbrideco	n. lit. unbridled-ness	w
]

_misi_ = [
quest	misio	n.	w
mission	misio	n.important commission from govt or church	
mission building	misiejo	n.	
mission complex	misiejo	n.	
]

_seg_ = [
sawmill	segejo	n.	w
double-handed saw	duoble tenila segilo	n. aka misery whip	w
]

_pupitr_ = [
lectern	pupitro	n.	
bookstand	pupitro	n.	
rostrum	pupitro	n.	
]

_ŝild_ = [
sign	ŝildo	n.	w
license plate	ŝildo	n.	w
signboard	ŝildo	n.	w
]

_ŝtorm_ = [
storm	ŝtormo	n.	w
sandstorm	sabloŝtormo	n. WEATHER	w
tiny sandstorm	sabloŝtormeto	n. WEATHER	
]

_fuŝ_ = [
blunder	fuŝi	v.tr	w
mess up	fuŝi	v.tr to mess (something) up	w
]

_pluk_ = [
pick	pluki	v.tr pick flowers	
pluck	pluki	v.tr pick (flowers)	
]

_vobl_ = [
wobble	vobli	v.ntr	w
wobbling	voblo	n.	w
]

_ced_ = [
yield	cedi	v.ntr	
are giving way	cedas	v.tr.ntr	
had given way	estis cedinta	phr.	
]

_neformal_ = [
informal	neformala	adj.	w
formality	formalaĵo	n.	w
]

_log_ = [
allurement	allogado	n.	w
has drawn	estas alloginta	phr. has been attracting	
seductively	deloge	adv.	w
]

_specif_ = [
certain	specifa	adj. having unique properties	
]

_evident_ = [
evidently	evidente	adv.	w
obvious	evidenta	adj.	w
truism	evidentaĵo	n.	w
]

_trog_ = [
trough	trogo	n.	w
manger	staltrogo	n.	w
]

_flut_ = [
flute	fluto	n.	w
pipe	fluto	n. musical	w
piping	flutado	n.  piping, the music of a pipe	w
]

_mensog_ = [
lie	mensogi	v.tr be mendacious ie tell untruths	w
lie	mensogo	n. an untruth	
lies	mensogoj	n. untruths	
]

_trivial_ = [
low class	triviala	adj.	w
indelicate	triviala	adj.	w
vulgar	triviala	adj.	w
]

_ofend_ = [
insult	ofendi	v.tr	w
offend	ofendi	v.tr	w
]

_lun_ = [
moon	luno	n.	w
moonless	senluna	adj.	w
crescent moon	lunarko	n.	w
]

_morn_ = [
gloom	morno	n.	w
gloomy	morna	adj. Dark and depressing	w
]

_kult_ = [
worship	kulti	v.tr kulti is more insitituional than adori	w
]

_banal_ = [
banal	banala	adj. boringly predictable	w
]

_fatal_ = [
bad luck	fatalo	n.	
fell fate	fatalo	n.	
]

_pudr_ = [
face powder	pudro	n.	w
]

_tru_ = [
hole	truo	n.	
nostril	naztruo	n.	w
]

_ide_ = [
idea	ideo	n.	w
brother	samideano	n. as in “Hallelujah brother!”	
comrade	samideano	n.	
fellow Esperantist	samideano	n.	
sister	samideano	n. as in “Hallelujah sister!”	
]

_supoz_ = [
suppose	supozi	v.tr	w
assumed	supozita	adj. believed as a default, without proof	w
presumably	supozeble	adv.	w
take it	supozi	v.tr	w
guess	supozi	v.tr idiomatic	w
]

_fascin_ = [
fascinate	fascini	v.tr	w
fascination	fascinado	n.	w
fascinated	fascinite	adv.	
fascination	fascino	n. phenomenon, caused by the one who fascinates	w
]

_inklin_ = [
inclination	inklino	n.  natural, lasting or not, aiming of the soul at something	w
affection	korinklino	n.	w
]

_mizer_ = [
miserable	mizera	adj.	w
]

_obsed_ = [
obsess	obsedi	v.tr	w
mooned	tag'revis obsede	phr. daydreamed obsessively	w
]

_leter_ = [
note	letereto	n. short letter written to someone else	w
]

_optimism_ = [
optimist	optimisma ulo	phr. one who always sees the best	
]

_spektakl_ = [
pageantry	spektaklo	n.	w
showman	spektaklulo	n.	w
]

_urn_ = [
urn	urno	n.	w
]

_ost_ = [
bone	osto	n.	W
big-boned	grand’osta	adj.	w
ossuary	ostejo	n.	w
]

_mien_ = [
expression	mieno	n. appearance of the face	w
bearing	mieno	n. how one presents oneself	w
presence	mieno	n.	w
]

_majest_ = [
majestic	majesta	adj. 	w
]

_riverenc_ = [
bow	riverenci	v.tr lean as a sign of respect	w
]

_akompan_ = [
accompanying	akompanante	adv.	
kept me company	akompanis min	phr.	
kept me company	akompanis min	phr.	
]

_lik_ = [
leak	liki	v.ntr as a container	
leak	likiĝi	v.ntr as a fluid	
]

_publik_ = [
public	publika	adj.	w
audience	publiko	n.	w
]

_telefon_ = [
phone	poŝtelefono	n. cell phone	w
telephone	telefono	n.	
]

_deprim_ = [
depressed	deprimita	adj.	
depression	deprimo	n. sub-clinical depression	
]

_aprob_ = [
approval	aprobo	n.	w
]

_metro_ = [
subway	metroa	adj.	w
]

_preciz_ = [
accurate	preciza	adj.	
exactitude	precizeco	n.	w
exactly	precize	adv.	w
inaccurately	malprecize	adv.	
just	precize	adv. exactly	
precise	preciza	adj.	w
]

_problem_ = [
problem	problemo	n.	
no problem	senprobleme	adv.	w
]

_pozici_ = [
position	pozicio	n. the way one occupies space	
way	pozicio	n. position	
]

_dispozici_ = [
arrange	dispozicii	v.tr.ntr	
place	dispozicii	v.tr.ntr arrange	
set out	dispozicii	v.tr.ntr arrange	
]

_ekspozici_ = [
exhibit	ekspozicio	n.	
exhibitions	ekspozicioj	n.	
]

_ekzist_ = [
exist	ekzisti	v.ntr	w
existence	ekzisto	n.	w
existence	ekzistado	n. the ongoing fact of one's existing	w
there were	ekzistis	v.ntr there existed	w
preexistence	antaŭekzisto	n.	w
]

_turment_ = [
torment	turmenti	v.tr	w
tormented	turmentis	v.tr	w
]

_spur_ = [
trace	spuri	v.tr to follow traces left by an action	
trackless	sen'spura	adj.	w
]

_stigmat_ = [
mark	stigmato	n. esp of infamy	
scar	stigmato	n.	
birthmark	stigmato	n.	w
]

_disk_ = [
disc	disko	n. 	w
disk	disko	n. 	
]

_penetr_ = [
penetrate	penetri	v.tr.ntr	w
was upon	trapenetris	v.tr permeated	
]

_deviz_ = [
watchword	devizo	n.	w
motto	devizo	n.	
]

_fraŭl_ = [
master	fraŭlo	n.	
miss	fraŭlino	n.	
girl	fraŭlino	n. young lady, unmarried woman	w
maiden	fraŭlino	n.	w
]

_skrap_ = [
scrape out	elskrapi	v.tr
]

_konkur_ = [
compete	konkuri	v.ntr	
competition	konkuro	n. action of one who competes	w
competitor	konkuranto	n.	w
]

_konkurenc_ = [
competition	konkurenco	n. rivalry, especially commercial or political	
]

_konkurs_ = [
contest	konkurso	n. with judges and rules	w
]

_danĝer_ = [
peril	danĝero	n.	w
dangerous	danĝera	adj.	w
]

_difekt_ = [
damage	difekti	v.tr cause damage to	w
break	difekti	v.tr	
spoil	difekti	v.tr	
]

_sistem_ = [
system	sistemo	n.	w
]

_persekut_ = [
sue	persekuti	v.tr in court	w
hunt	persekuti	v.tr	
persecute	persekuti	v.tr	
pursue	persekutis	v.tr	
torment	persekuti	v.tr persecute	
]

_rul_ = [
tumbling	ruliĝante	adv.	
you’d come tumbling back	vi venus reruliĝi	phr.	
]

_person_ = [
character	persono	n. character in a work of fiction	w
persons	personoj	n.	
personality	personeco	n. what constitutes the person	w
]

_pres_ = [
print	presi	v.tr	w
printed	presita	adj.	
]

_bibliotek_ = [
library	biblioteko	n.	w
]

_paper_ = [
scroll	rulpapero	n. 	w
brown-paper	brunpapera	adj. made of brown paper 	w
]

_roman_ = [
novel	romano	n.	w
romance	romaneco	n.	
]

_civit_ = [
citizen	civitano	n.	w
]

_konsist_ = [
consist	konsisti	v.ntr	w
]

_tener_ = [
tender	tenera	adj.  tenderness and warmth of feelings	W
tenderly	tenere	adv.	w
tenderness	tenereco	n. gentleness and warmthtenereco	w
]

_tortur_ = [
torture	torturi	v.tr	
tortured	torturita	adj.	w
]

_intest_ = [
intestine	intesto	n. part of the intestines	w
intestinal	intesta	adj. related to the intestines	w
intestine	intestaro	n. all of the intestines	w
intestines	intestaro	n. all of the intestines	w
bowels	intestaro	n.	w
]

_pied_ = [
foot	piedo	n.	w
feet	piedoj	n.	w
on foot	piede	adv.	w
beat it	forpiedu	v.ntr go away, but in an intentionally slangy way	
rising to her feet	leviĝanta sur siajn piedojn	phr.	s
]

_najbar_ = [
neighbour	najbaro	n.	
neighbourhood	najbaraĵo	n. not to be confused with kvartalo (district)	
]

_skold_ = [
scold	skoldi	v.tr admonish with reproach	w
]

_damp_ = [
muffled	dampita	adj. 	w
]

_humur_ = [
wit	humuro	n.	
humor	humuro	n. wit	w
]

_pajac_ = [
buffoon	pajaco	n.	
clown	pajaco	n. buffoon	
joking around	pajacado	n.	
pranks	pajacaĵoj	n.	
practical jokes	pajacaĵoj	n.	
]

_plend_ = [
complain	plendi	v.ntr	
]

_korekt_ = [
correct	korekta	adj. relating to correction	
corrective	korekta	adj.	w
correct	korekti	v.tr	w
correcting	korektante	adv.	s
]

_tranĉ_ = [
cut	tranĉi	v.tr to cut with a knife	
sawn-off	tranĉita	adj.	
]

_aktual_ = [
current	aktuala	adj.	w
topical	aktuala	adj.	w
up to date	aktuala	adj.	w
present-day	aktuala	adj.	w
]

_agit_ = [
churning	agitadanta	adj.	
agitation	agitado	n. act of one who agitates	w
agitation	agitiĝo	n. a state of excitement	w
]

_intrig_ = [
plot	intrigo	n. cunning activity to make or break a cause	w
scheme	intrigo	n.	w
plotting	intrigado	n.	w
plotting	intrigi	v.ntr	w
intriguing	intrigado	n. scheming	w
]

_emfaz_ = [
emphasise	emfazi	v.tr	w
emphasize	emfazi	v.tr	w
emphatically	emfaze	adv.	
]

_kritik_ = [
finding fault	kritiki	v.tr	
faultfinding	troa kritikado	phr. excessive criticism	w
critic	kritikisto	n. media critic	w
]

_marĉand_ = [
bargain	marĉandi	v.ntr	w
]

_bazar_ = [
market	bazaro	n. outdoor market, flea market	w
marketplace	bazaro	n.	w
]

_mastr_ = [
mistress	mastrino	n.	w
housewife	dommastrino	n.	w
]

_vin_ = [
wine	vino	n.	
vineyard	vinberejo	n.	w
]

_laguno_ = [
lagoon	laguno	n.	w
]

_ĵaluz_ = [
jealousy	ĵaluzo	n.	w
jealous	ĵaluza	adj.	w
possessive	ĵaluza	adj.	
]

_paprik_ = [
red pepper	papriko	n.	w
paprika	papriko	n.	w
]

_suker_ = [
candy	sukeraĵo	n.	w
confection	sukeraĵo	n.	w
]

_farĉ_ = [
stuff	farĉi	v.tr esp food: pork chops, grape leaves etc.	w
stuffed	farĉita	adj.	w
]

_kost_ = [
costliest	plej kosta	adj.	
cheap	malmultekosta	adj.	w
]

_komerc_ = [
business	komerco	n.	
trade	komerci	v.ntr BUSINESS	w
merchant	komercisto	n. BUSINESS	w
]

_monstr_ = [
monster	monstro	n.	W
monstrous	monstra	adj.	w
monstrosity	monstraĵo	n.	w
]

_fam_ = [
fame	famo	n.	w
infamous	fifama	adj.	w
]

_mekanik_ = [
mechanics	mekaniko	n. statics & dynamics, the parts of a machine SCHOOL	w
mechanical	mekanika	adj. related to machanics, made by machine	w
]

_muzik_ = [
music	muziko	n.	w
]

_invad_ = [
invade	invadi	v.tr	w
]

_verd_ = [
green	verda	adj.	w
greenish	verdeta	adj.	w
evergreen	ĉiamverdo	n.	w
]

_rikan_ = [
sneer	rikani	v.ntr	w
cackle	rikani	v.ntr cackle malevolently	w
]

_fot_ = [
take a picture	foti	v.tr	w
camera	fotilo	n. esp a still camera 	w
photograph	fotografaĵo	n.	w
]

_ring_ = [
earrings	orelringoj	n.	w
rings	gimnastikaj ringoj	n. gymnastic rings	w
]

_raked_ = [
tennis racket	rakedo	n.	w
snowshoe	rakedo	n.	w
]

_kron_ = [
crown	kroni	v.tr	w
]

_firma_ = [
enterprise	firmao	n. COMMERCE	w
firm	firmao	n. COMMERCE	
business	firmao	n.	
]

_kas_ = [
fund	kaso	n.	
cash register	kaso	n.	
till	kaso	n. cash register	w
coin bank	kaso	n.	
treasurer	kasisto	n.	
]

_sprot_ = [
sprat	sproto	n. kind of fish	w
]

_knab_ = [
boy	knabo	n.	w
boyish	knaba	adj.	w
boy’s	knaba	adj. boyish	
girl	knabino	n.	w
]

_patr_ = [
parent	gepatro	n.	
parents	gepatroj	n.	
forefathers	prapatroj	n.	
father	patro	n.	
mother	patrino	n.	
]

_fil_ = [
son	filo	n.	
daughter	filino	n. FAMILY	w
]

_riproĉ_ = [
chide	riproĉi	v.tr accuse, shame, express displeasure	w
]

_tremp_ = [
soak	trempi	v.tr	w
dip	trempetiĝi	v.ntr become dipped in liquid	
]

_putr_ = [
decay	putri	v.ntr decompose	
rotting	putranta	adj.	
]

_kis_ = [
kiss	kisi	v.tr	w
]

_eventual_ = [
possible	eventuala	adj.	
probably	eventuale	adv. more in the sense of possibly	
in case of need	eventuala	adj.	
]

_avanc_ = [
advancement	avancado	n.	
]

_frukt_ = [
fruit	frukto	n.	w
fruitless	senfrukta	adj.	w
]

_rav_ = [
rapt	ravite	adv.	w
enrapture	ravi	v.tr	w
]

_kask_ = [
helmet	skerma kasko	n. fencing helmet	
helmet	kasko	n. any sort of helmet 	w
]

_ĉapel_ = [
hat	ĉapelo	n.	w
]

_rev_ = [
dream	revo	n. aspirational, while awake	
dreamer	revulo	n. one who tends to dream rather than act	
dreamily	revade	adv.	w
]

_revelaci_ = [
revelation	revelacio	n.	w
]

_domin_ = [
dominated	dominis	v.tr	
]

_aktiv_ = [
actively	aktive	adv.	w
]

_ribel_ =  [
defect	ribeli	v.ntr to defect or rebel	
rebel	ribeli	v.ntr to defect	
]

_promes_ = [
promised	promesis	v.tr	
]

_prezident_ = [
president	prezidento	n. of a country or organization	
]

_prezid_ = [
preside	prezidi	v.tr	w
president	prezidanto	n. one presiding	w
president-elect	prezidonto	n.	w
holds high state	solene prezidas	phr.	s
]

_ripet_ = [
repeat	ripeti	v.tr say or do again	w
]

_podi_ = [
reviewing box	podio	n.	
rostrum	podio	n.	
pulpit	podio	n.	
speaker’s platform	podio	n.	
]

_haŭt_ = [
skin	haŭto	n.	W
swarthy	malhele haŭta	phr.	w
swarthy	olive-haŭtan	adj. olive complextion	w
]

_sang_ = [
blood	sango	n.	w
blood	prasango	n. fig. ancestral blood	
thin-blooded	malfortik'sanga	adj.	s
]

_naz_ = [
nose	nazo	n.	w
noselessness	sennazeco	n.	w
sniff	ekmovi la nazon	phr. move the nose as with displeasure	w
]

_flar_ = [
sniff	flari	v.tr to smell a smell	w
sniff	ekflari	v.tr take a sniff	w
]

# HEART
_kor_ = [
heart	koro	n.	w
hearty	elkora	adj.	w
heartfelt	elkora	adj.	w
half-heartedness	duona koreco	n.	w
bighearted	grandkora	adj.	w
from the heart	kore	adv. idiom	w
lighthearted	malpeze kora	phr.	w
at heart	je koro	phr.	w
]

_krani_ = [
skull	kranio	n.	w
cranium	kranio	n.	w
]

_kraĉ_ = [
spit	kraĉi	v.tr.ntr	w
spat	kraĉis	v.tr.ntr	w
]

_brov_ = [
brow	brovo	n. eyebrow	w
eyebrow	brovo	n.	w
]

_konsent_ = [
agree	konsenti	v.ntr	w
consent	konsento	n. pleasant or unpleasant perceived sensation	
agree	interkonsenti	v.ntr	w
]

_menci_ = [
mention	mencii	v.tr	w
]

_paŭt_ = [
pout	paŭti	v.ntr	w
brooding	paŭte ŝvebanta	phr.	
]

_surd_ = [
deaf	surda	adj.	w
deafening	surdiga	adj.	w
]

_spir_ = [
inhale	enspiri	v.tr	w
gasp	aĥ-enspiri	v.tr inhale with surprise	w
gasp	akrenspiri	v.tr a sharp inhalation	w
exhalation	elspiro	n.	w
breath	spiro	n.	w
breathless	senspire	adv.	w
]

_suspir_ = [
sigh	suspiro	n.	w
sigh	suspiri	v.ntr	w
]

_krur_ = [
leg	kruro	n.	w
stout-legged	dike kruraj	phr.	s
foreleg	antaŭkruro	n. 	w
]

_furz_ = [
fart	furzi	v.ntr	w
break wind	furzi	v.ntr	w
]

_hurl_ = [
howling	hurlante	adv.	w
]

_stal_ = [
stable	stalo	n. horse house (or other animals)	w
stall	stalo	n. stall in a stable	w
]

_ĉeval_ = [
horse	ĉevalo	n.	w
nag	ĉevaleto	n. small horse	w
lighted off my horse	deĉevaliĝis	v.ntr dismounted from a horse	w
]

_gut_ = [
drip	guti	v.ntr like a drop or like a wet thing	w
dripping	gutanta	adj. like a drop or like a wet thing	
]

_pilier_ = [
pillar	piliero	n.	w
]

_inund_ = [
flood	inundo	n.	w
in flood	inundanta	adj. having been flooded	s
]

_duŝ_ = [
take a shower	sin duŝi	v.ntr	w
]

_plank_ = [
floor	planko	n.	w
]

_pont_ = [
bridge	ponto	n.	w
]

_konvenci_ = [
convention	konvencio	n. social norm	w
]

_ros_ = [
dew	roso	n.	w
]

_abomen_ = [
detestable	abomeninda	adj. disgusting	w
]

_tabel_ = [
table	tabelo	n. column of numbers 	w
]

_kontinu_ = [
continuous	kontinua	adj. 	w
]

_are_ = [
area	areo	n. 	w
]

_diĝit_ = [
digit	diĝito	n.	
digital	diĝito	n.	
]

_cifer_ = [
digit	cifero	n. number	w
number	cifero	n. digit, written sign for a number	w
numeral	cifero	n. digit	w
]

_musk_ = [
moss	musko	n.	w
moss-grown	muske kreskita	phr.	s
]

_branĉ_ = [
branch	branĉo	n.	w
bough	branĉo	n.	w
twig	branĉeto	n.	w
]

_plant_ = [
plant	planto	n.	w
]

_makabr_ = [
ghastly	makabra	adj. ghostlike, evoking death	w
]

_diboĉ_ = [
be degenerate	diboĉi	v.ntr	
be dissolute	diboĉi	v.ntr	
be licentious	diboĉi	v.ntr	
be profligate	diboĉi	v.ntr	
attend orgies	diboĉi	v.ntr	
make excessively merry	diboĉi	v.ntr	
]

_maŝin_ = [
mechanically	maŝine	adv. by means of a machine or as if a machine	w
machinery	maŝinaro	n.	w
]

_frivol_ = [
lightness	frivoleco	n. frivolity	
]

_lokal_ = [
locale	lokalo	n. part of a building with a definite purpose	
place	lokalo	n. part of a building with a definite purpose	
]

_stigm_ = [
spiracle	stigmo	n. respiratory structure of an animal	w
pore	stigmo	n.	
pistil	stigmo	n. receptive surface of a flower	w
]

_resum_ = [
summary	resumo	n.	w
abstract	resumo	n.	w
résumé	resumo	n.	
]

_embaras_ = [
embarrassment	embaraso	n.	w
]

_agent_ = [
agent	agento	n.	w
]

_rigor_ = [
strict	rigora	adj.	w
rigorous	rigora	adj.	w
]

_konstat_ = [
scientifically demonstrate	konstati	v.tr ascertain	
discover	konstati	v.tr ascertain	
find out	konstati	v.tr ascertain	
prove	konstati	v.tr ascertain	
]

_protekt_ = [
protect	protekti	v.tr esp through influence or authority	w
protection	protekto	n.	w
protective	protekta	adj.	w
protectively	protekte	adv.	w
]

_or_ = [
gold	oro	n.	w
golden	ora	adj.	w
edged with gold	rande orumita	adj. 	s
]

_arĝent_ = [
silver	arĝenta	adj.	w
silver	arĝento	n.	w
]

_gas_ = [
gas	gaso	n. state of matter	w
gases	gasoj	n.	w
]

_kot_ = [
mud	koto	n.	w
muck	koto	n. mud	w
]

_funebr_= [
mournful	funebra	adj. 	w
funeral	funebra	adj. 	w
]

_sof_ = [
sofa	sofo	n. furniture	w
]

_titol_ = [
headed	titolita	adj. had a text heading of	
entitled	titolita	adj. given the title of	w
]

_eskap_ = [
escape	eskapi	v.tr.ntr	w
]

_fakt_ = [
fact	fakto	n.	w
]

_ignor_ = [
ignore	ignori	v.tr	w
disregarding	ignorante	adv. while ignoring	s
]

_konsider_ = [
dreamed of	konsideris	v.tr considered	
takes no account of me	ne konsideras min	phr.	
considering	konsiderante	adv. in light of	w
]

_komplik_ = [
complicated	komplika	adj.	w
]

_efik_ = [
effect	efiko	n. action of something having an effect	w
effective	efika	adj.	w
efficacious	efika	adj.	w
]

_jen_ = [
here is	jen	part.	s
here's	jen	part.	w
here was	jen	part.	s
there’s	jen	part. behold	w
that’s all	jen ĉio	phr.	w
here and there	jen kaj jen	phr.	w
there, now	jen, nun	interj.	s
there	jen	interj.	w
there, there	jen, jen.	interj. comforting words	w
there, now	jen, nun	interj.	s
behold	jen	interj.	w
as follows	jene	adv.	s
this	jeno	n. the following, "this" which follows	w
]

_poŝ_  = [
pocket	poŝo	n.	w
]

_ironi_ = [
ironically	ironie	adv.	w
]

_kaj_ = [
and	kaj	conj.	w
both	kaj	conj. kaj ... kaj, both ... and	w
]

_ekzempl_ = [
example	ekzemplo	n.	w
instance	ekzemplo	n.	w
]

_river_ = [
river	rivero	n.	w
stream	rivereto	n.	w
]

_mont_ = [
mount	monto	n. part of the name of a mountain	w
mountain	monto	n.	w
hill	monteto	n.	w
]

_bord_ = [
bank	bordo	n. as in river-banks	w
seacoast	marbordo	n.	w
shore	bordo	n.	w
]

_kanton_ = [
canton	kantono	n. Swiss canton	w
county	kantono	n. U.S. county	w
]

_rajd_ = [
ride	rajdi	v.tr.ntr to ride astride something	w
]

_breĉ_ = [
rift	breĉo	n.	w
]

_pec_ = [
scrap	pecaĉo	n.	w
piece	peceto	n.	
]

_ŝut_ = [
pour	ŝuti	v.tr pour a non-liquid	
]

_bokal_ = [
jar	bokalo	n.	w
fishbowl	bokalo	n.	w
]

_sprit_ = [
witty	sprita	adj.	w
clever	sprita	adj.	w
]

_kongres_ = [
congress	kongreso	n.	w
convention	kongreso	n.	w
]

_nub_ = [
cloud	nubo	n.	w
]

_magazen_ = [
department store	magazeno	n. 	w
supermarket	magazeno	n. 	w
magazine	magazeno	n. for explosives	w
shop	magazeno	n.	
warehouse	magazeno	n.	w
]

_ne_ = [ 
not	ne	adv.	
]

_avert_ = [
warn	averti	v.tr	w
warning	averto	n.	w
]

_peĉ_ = [
bad luck	peĉo	n.	w
pitch	peĉo	n. tar	w
tar	peĉo	n.	s
]

_sabl_ = [
sand	sablo	n.	w
sandy	sabla	adj.	w
]

_sezon_ = [
season	sezono	n.	w
unseasonably	malsezone	adv.	w
]

_komplez_ = [
gracious	kompleza	adj. courteous, obliging	w
]

_arm_ = [
men of arms	armuloj	n. 	w
]

_malav_ = [
generous	malavara	adj.	w
]

_van_ = [
idle	vana	adj. fruitless	w
in vain	vane	adv.	w
vainly	vane	adv.	w
vain	vana	adj. non-productive	w
]

_mur_ = [
wall	muro	n. ARCHTECTURE	w
]

_reciprok_ = [
in return	reciproke	adv.	w
]

_diluv_ = [
deluge	diluvo	n.	w
]

_persvad_ = [
persuasion	persvado	n.	w
persuade	persvadi	v.tr	w
win over	persvadi	v.tr	w
]

_humil_ = [
humbly	humile	adv.	w
]

_princ_ = [
prince	princo	n.	w
princess	princino	n.	w
]

_princip_ = [
principle	principo	n. fundamental idea	w
]

_geni_ = [
genius	genio	n. great ability	w
genius	geniulo	n. a person with great ability	w
]

_net_ = [
distinct	neta	adj.	
clearly visible	neta	adj.	
rough draft	malneto	n.	
]

_rezult_ = [
result	rezulto	n.	w
consequence	rezulto	n.	w
effect	rezulto	n.	w
]

_medi_ = [
environment	medio	n.	w
]

_medium_ = [
medium	mediumo	n. spirit medium	w
]

_infer_ = [
infernal	infera	adj. 	w
hellish	infera	adj.	w
]

_event_ = [
event	evento	n.	w
]

_flos_ = [
floated	flosis	v.ntr	w
]

_invit_ = [
invite	inviti	v.tr	w
]

_uz_ = [
use	uzi	v.tr	
it is used	ĝin uzitas	phr.	s
age-worn	epoke eluzita	phr.	s
]

_moder_ = [
in moderation	modere	adv.	w
]

_aer_ = [
air	aero	n.	w
]

_atenc_ = [
assault	atenci	v.tr	
rape	seksatenci	v.tr	
]

_salubr_ = [
unwholesome	nesalubra	adj.	w
]

_gest_ = [
makes a gesture	gesti	v.ntr	w
]

_fand_ = [
melt away	forfandiĝi	v.ntr	w
merge	kunfandiĝi	v.ntr become melted together	w
]

_kultiv_ = [
cultivate	kultivi	v.tr cultivate crops 	w
till	kultivi	v.tr till the soil	w
]

_vant_ = [
vain	vanta	adj. related to vanity	w
]

_pitoresk_ = [
picturesque	pitoreska	adj.	w
picturesqueness	pitoreskeco	n.	w
]

_skulpt_ = [
sculpture	skulptaĵo	n. 	w
]

_kongru_ = [
matchless	senkongrua	adj.	w
]

_desegn_ = [
draw	desegni	v.tr 	w
]

_lak_ = [
lacquer	laki	v.tr apply lacquer ie varnish 	w
lacquer	lako	n. ie varnish 	w
]

_lini_ = [
line	linio	n. linear mark or line of text	w
curvilinear	kurbe-linia	adj. ART	w
first few lines	unuajn kelkajn liniojn	phr.	s
]

_slab_ = [
slab	slabo	n. eg over a grave	w
]

_maŭzole_ = [
mausolean	maŭzolea	adj.	w
mausoleum	maŭzoleo	n.	w
]

_komod_ = [
chest of drawers	komodo	n.	w
]

_raŭk_ = [
hoarse	raŭka	adj.	w
]

_mut_ = [
dumbly	mute	adv.	
]

_glos_ = [
glossary	glosaro	n. 	w
]

_print_ = [
print out	printi	v.tr eg from a computer file	
]

_rostr_ = [
snout	rostro	n.	w
proboscis	rostro	n.	w
trunk	rostro	n.	w
]

_kavern_ = [
cave	kaverno	n. esp a natural cave	w
cavern	kaverno	n.	w
]

_strangol_ = [
choking	strangolanta	adj. strangling	
]

_asert_ = [
claim	aserti	v.tr express in good faith an opinion that a thing is true	w
assert	aserti	v.tr express in good that a thing is true	w
]

_par_ = [
pair	paro	n.	w
couple	paro	n.	w
]

_rent_ = [
dividend	rento	n.	
interest payment	rento	n.	
interest rate	rentumo	n.	w
]

_emoci_ = [
emotion	emocio	n.	w
affect	emocio	n. an emotion	
]

_pram_ = [
ferryboat	pramo	n.	w
]

_ĉantaĝ_ = [
blackmail	ĉantaĝo	n.	w
racket	ĉantaĝo	n. corrupt enterprise; especially blackmail	w
]

_ond_ = [
wave	ondo	n.	w
]

_neglekt_ = [
neglected	neglektata	adj.	w
]

_pasi_ = [
passionately	pasie	adv.	w
]

_novic_ = [
novice	novico	n. religious order or inexpert	w
]

_mebl_ = [
furniture	meblo	n. piece of furniture	w
]

_ŝrik_ = [
shrieks	ŝrikoj	n.	w
shriek forth	elŝriki	v.ntr	s
]

_kalumni_ = [
slander	kalumnio	n.	w
libel	kalumnio	n.	w
]

_magi_ = [
magical	magia	adj.	w
]

_kaldron_ = [
cauldron	kaldrono	n. 	w
]

_kaldron_ = [
elf	elfo	n.	w
sprite	elfo	n.	w
]

_aŭgur_ = [
omen	aŭguro	n. more mystical 	w
prophesied	aŭguris	v.tr	
portentous	malbonaŭgura	adj.	w
]

_bizar_ = [
bizarre	bizara	adj.	w
]

_familiar_ = [
familiarly	familiare	adv.	w
]

_dens_  = [
thickly	dense	adv.	w
]

_produkt_ = [
produce	produkti	v.tr	w
]

_projekt_ = [
design	projekto	n. plan of action	w
]

_modest_ = [
demurely	modeste	adv.	w
]

_objekt_ = [
object	objekto	n. physical object; mental concept; grammatical object	w
thing	objekto	n. object	w
concept	objekto	n. physical object; mental concept; grammatical object	
]

_ĉas_ = [
hunt	ĉasi	v.tr	w
]

_punkt_ = [
point	punkto	n. exact location	w
]

_afiŝ_ = [
poster	afiŝo	n.	w
]

_sincer_ = [
truly	sincere	adv. sincerely	w
candor	sincereco	n.	w
]

_hor_ = [
hour	horo	n.	w
what time is it	kioma horo estas	phr.	w
half an hour	duona horo	phr.	w
lost track of the hours	perdis la spuron de la horoj	phr.	
an hour ago	antaŭ horo	phr.	s
]

_insul_ = [
island	insulo	n.	
]

_orgi_ = [
orgy	orgio	n. wild party	w
]

_krajon_ = [
pencil	krajono	n.	w
]

_poz_ = [
pose	pozo	n.	w
]

_procez_ = [
process	procezo	n. as a natural process	w
natural process	procezo	n.	s
]

_propon_ = [
offer	proponi	v.tr offer something or to do something	w
]

_celebr_ = [
observed	celebrita	adj. ritual celebration	s
]

_perspektiv_ = [
outlook	perspektivo	n.	
]

_grund_ = [
soil	grundo	n. soil	w
]

_varlet_ = [
squire	varleto	n.	w
]

_sven_ = [
swooning	svenigema	adj. prone to induce swooning	s
]

_elefant_ = [
elephant	elefanto	n.	w
]

_muŝ_ = [
flies	muŝoj	n.	w
]

_ekspres_ = [
express	ekspreso	n.	w
]

_bier_ = [
beer	biero	n.	w
have a beer	bierumi	v.ntr	s
]

_staci_ = [
station	stacio	n.	w
station	stacidomo	n.	w
]

_felt_ = [
felt	felto	n.	w
]

_statik_ = [
static	statika	adj.	w
]

_venĝ_ = = [
vindictive	venĝema	adj. 	w
]

_trafik_ = [
traffic	trafiko	n.	w
]

_fum_ = [
smoking	fuma	adj. smokey	w
]

_mumi_ = [
mummified	mumiigita	adj.	w
mummy	mumio	n.	w
]

_kabinet_ = [
cabinet	kabineto	n. in a government	
study	kabineto	n.	
exhibition hall	kabineto	n. small exhibition hall	
office	kabineto	n.	
]

_rendevu_ = [
engagement	rendevuo	n.	w
appointment	rendevuo	n.	w
]

_plac_ = [
square	placo	n. in a street adress ie town square	w
]

_palm_ = [
palm	palmo	n. palm tree	w
palm-tree	palmo	n. palm tree	w
]

_pin_ = [
pine woods	pinaro	n.	s
]

_rosmaren_ = [
rosemary	rosmareno	n.	w
]

_cinik_ = [
indecent	cinika	adj. esp. of people	
libertine	cinika	adj. esp. of people	
libertine	cinikulo	n. a libertine person	
obscene	cinika	adj. esp. of people	
]

_mit_ = [
myth	mito	n.	w
mythology	mitologio	n.	w
mythic	mita	adj. 	w
scholar of mythology	mitologo	n.	w
]


_fenomen_ = [
phenomenon	fenomeno	n.	w
phenomena	fenomenoj	n.	w
]

_dolar_ = [
buck	dolaro	n. dollar	w
dollar	dolaro	n.	w
]

_valiz_ = [
bag	valizo	n. suitcase	w
]

_nokt_ = [
spend the night	tranokti	v.ntr	s
spent nights	tranoktis	v.ntr	s
night	nokto	n.	w
tonight	ĉi-nokte	adv.	
]

_operaci_ = [
operation	operacio	n.	w
]

_planed_ = [
planet	planedo	n.	w
]

_profit_ = [
profit from	profiti	v.tr	w
take advantage of	profiti	v.tr	w
]

_mol_ = [
tender	mola	adj. in regard to meat	w
]

_ĵak_ = [
jack	ĵako	n. electrical or telephone jack ELECTRIC	w
]

_krad_ = [
lattice	kradita	adj. covered by a lattice	
]

_lek_ = [
lick	leki	v.tr	w
]

_luks_ = [
luxury	lukso	n.	w
luxuriance	lukseco	n.	w
]

_mor_ = [
manners	moroj	n. eg 'mind your manners'	w
]

_mark_ = [
mark	marko	n.	w
]

_ebl_ = [
be possible	ebli	v.ntr	s
enabled	ebligis	v.ntr	w
impossible	neeble	adv.	w
might	eble	adv.	w
perhaps	eble	adv.	w
possibly	eble	adv.	w
opportunities	ebloj	n. options	w
maybe	eble	adv.	w
as possible	kiel eble	adv.	s
as possible	kiel eble plej	phr.	s
as possible	laŭeble	adv.	s
]

_akcident_ = [
unglücksfall	akcidento	n. German, accident	
]

_kverk_ = [
oaken	kverka	adj.	w
oak	kverko	n. oak tree	w
]

_forc_ = [
greenhouse	forcejo	n.	w
conservatory	forcejo	n.	w
]

_kolekt_ = [
collection	kolekto	n.	w
]

_kamer_ = [
chamber	kamero	n. in a machine as combustion chamber	w
closet	kamero	n.	
]

_geril_ = [
guerilla	gerilano gerilisto	n.	w
guerilla war	gerilo	n.	w
]

_absint_ = [
absinthe	absinto	n.	w
]

_kopi_ = [
photocopy	kopio	n.	
imitation	kopio	n.	w
reproduction	kopio	n.	
]

_trajn_ = [
train	trajno	n.	w
express	eksprestrajno	n. express train	
]

_intervju_ = [
interview	intervjuo	n.	w
]

_tajd_ = [
tide	tajdo	n.	w
]

_kript_ = [
vault	kripto	n.	w
cryptical	kripta	adj.	w
]

_latun_ = [
brass	latuno	n. 	w
]

_raket_ = [
rocket	raketo	n.	w
]

_ŝlim_ = [
slime	ŝlimo	n.	w
sludge	ŝlimo	n.	w
]

_fantasm_ = [
phantasm	fantasmo	n.	w
]

_plag_ = [
haunted	plagita	adj. haunted figuratively	w
]

_ogr_ = [
ogre	ogro	n. 	w
]

_bobel_ = [
bubbled	bobelis	v.ntr	w
bubbling	bobelanta	adj.	w
]

_apelaci_ = [
appeal	apelacii	v.ntr	w
]

_teren_ = [
country	tereno	n. terrain	s
]

_etiked_ = [
label	etikedo	n.	w
]

_plur_ = [
several	pluraj	adj.	w
]

_kategori_ = [
category	kategorio	n.	w
]

_divers_ = [
varied	diversa	adj.	w
various	diversa	adj.	w
]

_nuanc_ = [
touch	nuanco	n. delicate distinction	
]

_parentez_ = [
side comment	parentezo	n.	s
parenthetical expression	parentezo	n.	s
]

_polu_ = [
pollution	poluo	n. environmental pollution	w
environmental pollution	poluo	n.	s
]

_ekstrem_ = [
extremely	ekstreme	adv.	w
uttermost	plej ekstrema	adj.	w
]

_eskvizit_ = [
exquisite	eskvizita	adj.	w
]

_kruc_ = [
junction	vojkruciĝo	n.	w
]

_gigant_ = [
gigantic	giganta	adj.	w
]

_korupt_ = [
incorruptibility	nekorupteblo	n.	w
]

_registr_ = [
record	registri	v.tr	w
]

_egal_ = [
match	egali	v.tr	w
]

_babil_ = [
babble	babiladi	v.tr.ntr	w
chat	babili	v.tr.ntr	w
]

_aler_ = [
awning	alero	n. roof overhang 	w
roof overhang	alero	n.	
eave	alero	n. roof overhang	
]

_lamp_ = [
lamp	lampo	n.	
]

_akord_ = [
accord	akordo	n.	w
]

_semajn_ = [
week	semajno	n.	w
three weeks before	tri semajnojn antaŭe	adv.	
]
_histori_ = [
history	historio	n. 	w
prehistoric	prahistoria	adj. 	w
]

_geologi_ = [
geological	geologia	adj.	w
geology	geologio	n.	w
]

_frakas_ = [
smash	frakasi	v.tr	w
brittle	frakasebla	adj. shatterable	w
]

_ekran_ = [
screen	ekrano	n.	w
]

_konfit_ = [
jammy	konfitaĵa	adj.	w
]

_sordid_ = [
sordid	sordida	adj.	w
]

_glut_ = [
sucked under	estis englutita	phr. was swallowed	
take a pill	gluti pilolon	phr.	
]

_grot_ = [
small cave	groto	n. esp a decorated or artificial cave	
]

_proviz_ = [
supply	provizi	v.tr one usually provizas someone with (per or je) something	w
provision	provizi	v.tr one usually provizas someone 'with' (per or je) something	
]

_provizor_ = [
temporarily	provizore	adv.	w
]

_sobr_ = [
sober	sobra	adj.	w
]

_rub_ = [
rubbish	rubaĵo	n.	w
]

_divid_ = [
share	dividi	v.tr	
divide	dividi	v.tr 	w
]

_brak_ = [
arm	brako	n.	W
hug	brakumi	v.tr	w
embrace	brakumi	v.tr	w
]

_ceremoni_ = [
ceremony	ceremonio	n.	w
]

_kompani_ = [
company	kompanio	n. group of people or coexistence	w
]

_verdikt_ = [
dictum	verdikto	n. incl a bad diagnosis	
]

_esting_ = [
quench	estingi	v.tr cause to stop burning 	w
]

_pest_ = [
plague	pesto	n.	w
]

_nominal_ = [
nominal	nominala	adj.	w
]

_pup_ = [
doll	pupo	n.	w
]

_miks_ = [
mingle	intermiksiĝi	v.ntr	w
coming between	enmiksiĝis inter	phr.	w
was coming between	estis enmiksiĝanta inter	phr.	
]

_fulm_ = [
glistening	fulmetada	adj.	
]

_vortic_ = [
vortex	vortico	n.	w
]

_radius_ = [
radius	radiuso	n. 	w
]

_akv_ = [
water	akvo	n.	w
wasser	akvo	n. German, water	
]

_masiv_ = [
solid	masiva	adj. not porous (pora) or hollow (kava)	
]

_kran_ = [
faucet	krano	n.	w
]

_bambu_ = [
bamboo	bambuo	n.	w
]

_susur_ = [
rustle	susuro	n.	w
]

_hero_ = [
hero	heroo	n. 	w
]

_posed_ = [
possess	posedi	v.tr	w
]

_poezi_ = [
poetic	poezia	adj.	
]

_pensi_ = [
pension	pensio	n.	
retired person	pensiulo	n.	
retiree	pensiulo	n.	
]

_barb_ = [
greybeard	grizbarbo	n.	w
]

_infan_ = [
child	infano	n.	w
children	infanoj	n.	w
]

_konvink_ = [
convince	konvinki	v.tr	w
conviction	konvinkiĝo	n.	w
]

_interez_ = [
interest rate	interezo	n.	w
]

_impost_ = [
tax	imposti	v.tr	w
]

_volumen_ = [
volume	volumeno	n. area times thickness	w
]

_polur_ = [
polish	poluri	v.tr shine by rubbing	w
]

_likv_ = [
liquid	likvo	n.	w
]

_relikv_ = [
relic	relikvo	n.	w
]

_religi_ = [
religious	religia	adj.	w
religion	religio	n.	w
]

_monaĥ_ = [
monk	monaĥo	n.	w
half monk	duonmonaĥo	n.	s
]

_pastr_ = [
priest	pastro	n.	w
high priest	ĉefpastro	n.	
]

_templ_ = [
temple	templo	n.	w
]

_transcend_ = [
transcendent	transcenda	adj.	w
transcend	transcendi	v.tr	w
]

_bibli_ = [
bible	biblio	n. 	w
biblical	biblia	adj. 	w
]

_sekret_ = [
secret	sekreto	n.	w
]

_giĉet_ = [
sales counter	giĉeto	n.	
sales window	giĉeto	n.	
]

_balustrad_ = [
balustrade	balustrado	n.	w
railing	balustrado	n.eg around a balcony	w
]

_trak_ = [
track	trako	n.	w
]

_hotel_ = [
hotel	hotelo	n.	w
]

_titan_ = [
titanic	titana	adj. gigantic	w
]

_kanon_ = [
cannon	kanono	n. 	w
]

_tatu_ = [
tattoo parlor	tatuejo	n.	w
]

_katen_ = [
chain	kateni	v.tr put a person in chains	w
]

_svarm_ = [
teem	svarmi	v.ntr swarm	
]

_vernis_ = [
varnish	vernisi	v.tr apply varnish ie lacquer ART	w
varnish	verniso	n. ie lacquer ART	w
]

_galeri_ = [
gallery	galerio	n. ART	w
]

_ilustr_ = [
illustration	ilustraĵo	n.	w
]

_membr_ = [
member	membro	n.	w
]

_simbol_ = [
symbol	simbolo	n.	w
]

_pist_ = [
pound	pisti	v.tr	w
]

_vapor_ = [
vaporous	vapora	adj.	w
]

_eman_ = [
emanate	emani	v.ntr	w
]

_impres_ = [
impression	impreso	n.	w
]

_dezajn_ = [
pattern	dezajno	n. design pattern, layout, or aesthetic arrangement	
]

_klimat_ = [
climate	klimato	n.	w
]

_suĉ_ = [
sucked	suĉita	adj.	
]

_drat_ = [
wire	drato	n.	w
]

_tikl_ = [
tickled	tiklita	adj.	
]

_soldat_ = [
soldier	soldato	n.	w
]

_niĉ_ = [
niche	niĉo	n.	w
]

_kont_ = [
account	konto	n.	
accountant	kontisto	n.	
bookkeeper	kontisto	n.	
]

_teori_ = [
theoretical	teoria	adj. 	w
theory	teorio	n.	w
]

_scienc_ = [
sciences	sciencoj	n.	
scientific	scienca	adj.	w
]

_botel_ = [
bottled up	enboteligota	adj. put in a bottle in the future	
]

_manik_ = [
bare-armed	senmanika	adj. sleeveless	
]

_stel_ = [
star	stelo	n. star in the sky	w
]

_aspir_ = [
aspire	aspiri	v.tr.ntr	w
]

_bid_ = [
bead	bido	n.	w
]

_lard_ = [
lard	lardi	v.tr decorating something unnecessarily	w
]

_pigr_ = [
lazy	pigra	adj.	w
]

_apog_ = [
lean	apogi	v.tr to lean a thing against another thing to prop it up	
leant	apogis	v.tr to lean a thing against another thing to prop it up	
]

_jur_ = [
jurisprudence	juro	n. the science of law	w
]

_lord_ = [
lord	lordo	n. British nobility	
lady	lordino	n. British nobility	
]

_mas_ = [
mass	maso	n. in physics	w
quantity	maso	n. indefinite quantity	w
]

_evolu_ = [
evolve	evolui	v.ntr	w
evolutionist	evoluiisto	n.	w
be transformed	evolui	v.ntr	
]

_fut_ = [
foot	futo	n. distance measure	w
feet	futoj	n. distance measure	w
]

_abrupt_ = [
abruptly	abrupte	adv.	w
]

_aflikt_ = [
affliction	aflikto	n.	w
]

_konform_ = [
accordingly	konforme	adv. so that it's similar to a model object	w
]

_maksimum_ = [
at most	maksimume	adv.	w
]

_bilanc_ = [
balance	bilanci	v.tr balance an account	w
balance sheet	bilanco	n.	w
]

_aŭr_ = [
aura	aŭro	n.	w
]

_svag_ = [
vague	svaga	adj. indistict, ill-defined	w
]

_veter_ = [
weather	vetero	n.	w
]

_konvulsi_ = [
upheaval	konvulsio	n.	w
]

_noval_ = [
wool gathering	novali	v.ntr figuratively lie fallow	w
lie fallow	novali	v.ntr	s
]

_pes_ = [
weigh	pesi	v.tr to weigh an object	w
]

_univers_ = [
universe	universo	n.	w
]

_virg_ = [
virgin	virga	adj.	w
]

_juk_ = [
itches	jukas	v.tr (+sin)	w
]

_puls_ = [
throb	pulso	n.	w
]

_gaz_ = [
gauze	gazo	n.	w
]

_atak_ = [
attack	atako	n.	w
]

_fon_ = [
background	fono	n.	w
]

_aparten_ = [
belong	aparteni	v.ntr	w
]

_boat_ = [
boat	boato	n.	w
]

_situ_ = [
be situated	situi	v.ntr	w
]

_lantern_ = [
lantern	lanterno	n.	w
]

_paradiz_ = [
paradisal	paradiza	adj.	w
paradisiacal	paradiza	adj.	w
paradise	paradizo	n.	w
]

_parfum_ = [
perfume	parfumo	n.	w
]

_rezist_ = [
resist	rezisti	v.tr.ntr	w
irresistible	nerezistebla	adj.	w
]

_debit_ = [
retail	debiti	v.tr to sell retail	w
market	debito	n. market for something,wholesale or retail	
]

_ŝok_ = [
shock	ŝoko	n.	w
]

_dres_ = [
train	dresi	v.tr wild animals	
tame	dresi	v.tr wild animals	w
]

_triumf_ = [
triumph	triumfo	n.	w
triumphant	triumfa	adj.	w
triumphantly	triumfe	adv.	w
]

_rad_ = [
wheel	rado	n.	w
]

_radik_ = [
root	radiko	n. 	w
]

_ranunkol_ = [
buttercup	ranunkolo	n.	w
]

_gondol_ = [
take your gondola	per via gondola	phr.	s
]

_ĉerk_ = [
coffin	ĉerko	n. 	w
]

_kusen_ = [
cushion	kuseno	n.	w
pad	kuseneto	n.	w
]

_martel_ = [
padded hammer	kusenetita martelo	n. piano hammer	
]

_reĝisor_ = [
film producer	reĝisoro	n.	
stage manager	reĝisoro	n.	w
]

_teatr_ = [
theatre	teatro	n.	W
play	teatraĵo	n.	w
stage review	varia teatraĵo	n.	
]

_kadavr_ = [
corpse	kadavro	n.	w
]

_spegul_ = [
mirror	spegulo	n.	w
]

_lit_ = [
bed	lito	n.	w
]

_cenotaf_ = [
cenotaph	cenotafo	n.	w
]

_kanap_ = [
couch	kanapo	n.	w
]

_gratul_ = [
congratulating	gratuli	v.tr 	w
]

_balbut_ = [
stammer	balbuti	v.tr.ntr	w
]

_taburet_ = [
stool	tabureto	n.	w
]

_grumbl_ = [
grumble	grumbli	v.ntr	w
]

_bufon_ = [
jester	bufono	n. court jester	w
comic	bufono	n. crude comic performer	w
]

_region_ = [
region	regiono	n. 	w
]

_rigid_ = [
rigid	rigide	adv.	w
]

_odor_ = [
smell	odoro	n.	w
]

_roz_ = [
rose	rozo	n.	w
rose	roza	adj.	w
]

_mes_ = [
mass	meso	n. Catholic service	w
]

_klaŭn_ = [
clown	klaŭno	n. circus clown	w
]

_kontur_ = [
contour	konturo	n. 	w
outline	konturo	n. 	w
]

_bar_ = [
clear	debari	v.tr	w
]

_etap_ = [
stage	etapo	n. stopping places or the distance between them	
]

_piktur_ = [
pictorial	piktura	adj. 	w
]

_sesi_ = [
session	sesio	n.	w
]

_spekt_ = [
spectator	spektanto	n.	w
]

_talent_ = [
talent	talento	n.	w
]

_respons_ = [
take responsibility	responsi	v.ntr	w
]

_insist_ = [
insist	insisti	v.ntr	w
]

_pot_ = [
pot	poto	n.	w
saucepan	poto	n.	w
]

_bak_ = [
unbaked	nebakita	adj.	w
]

_spekulativ_ = [
speculative	spekulativa	adj. based on theoretical reasoning	w
]

_ŝuld_ = [
debt	ŝuldo	n.	w
]

_mon_ = [
money	mono	n.	w
gold piece	ora monero	n.	w
]

_stult_ = [
stupid	stulta	adj.	w
]

_cerb_ = [
brain	cerbo	n.	w
brooding	cerbumado	n.	w
]

_har_ = [
hair	hararo	n. a set of hair	w
hair	haro	n. a hair	w
]

_ŝultr_ = [
shoulder	ŝultro	n.	w
shoulder	surŝultrigi	v.tr put up on the shoulder	w
shrugging	levante la ŝultrojn	phr.	w
]

_libr_ = [
book	libro	n.	w
bookkeeper	librotenisto	n.	w
]

_hospital_ = [
hospital	hospitalo	n.	w
]

_frid_ = [
cold	frida	adj.	w
]

_plor_ = [
sob	ploregi	v.ntr	w
whine	plor'grinco	n. crying squeak	
]

_rankor_ = [
resentment	rankoro	n.	w
]

_guvern_ = [
be governess	guverni	v.tr	
be tutor	guverni	v.tr	
]

_lice_ = [
high school	liceo	n. esp in French-speaking countries	w
]

_maskl_ = [
male	masklo	n.	w
]

_kravat_ = [
necktie	kravato	n.	W
]

_juvel_ = [
jewel	juvelo	n. 	w
]

_novel_ = [
short story	novelo	n.	w
]

_kramf_ = [
cramp	kramfo	n. medical condition	w
]

_fanfar_ = [
fanfare	fanfaro	n. musical	w
]

_kin_ = [
cinema house	kinejo	n.	w
]

_afekci_ = [
affect	afekcii	v.tr create change in, have an emotional impact on	w
]

_ekskuz_ = [
excuse	ekskuzo	n.	w
]

_feri_ = [
holiday	ferio	n.	w
]

_esenc_ = [
essential	esenca	adj.	w
]

_komun_ = [
common	komuna	adj. shared	w
community	komunumo	n.	w
]

_komunik_ = [
communicate	komuniki	v.tr	w
report	komuniki	v.tr	w
]

_delic_ = [
delight	delico	n. pleasure	w
]

_pac_ = [
peace	paco	n.	w
]

_prez_ = [
price	prezo	n.	w
]

_famili_ = [
family	familio	n.	w
]

_fremd_ = [
stranger	fremdulo	n.	w
]

_buk_ = [
buckle	buko	n.	w
]

_reklam_ = [
advertisement	reklamaĵo	n. an ad	w
]

_kaz_ = [
case	kazo	n. eg law medicine grammar	w
]

_efrit_ = [
afreet	efrito	n. powerful evil jinni, demon, or monstrous giant in Arabic mythology	w
wind-wraith	vent-efrito	n. 	s
]

_tunel_ = [
tunnel	tunelo	n.	w
]

_provinc_ = [
province	provinco	n.	w
]

_map_ = [
map	mapo	n.	w
]

_abel_ = [
bees	abeloj	n. 	w
]

_rund_ = [
rounds	rundojn	n. as in, making the rounds	w
]

_konsol_ = [
solace	konsolo	n.	w
]

_stand_ = [
stand	stando	n. temporary sales or display area	w
]

_test_ = =[
test	testo	n. less significant than ekzameno	w
]

_tragedi_ = [
tragic	tragedia	adj.	w
]

_matras_ = [
vase	matraso	n. long-necked glass vase	w
]

_kojn_ = [
wedge	kojni	v.tr immobilize with a wedge	w
]

_kriz_ = [
crisis	krizo	n.	w
]

_soif_ = [
thirst	soifo	n.	w
]

_teler_ = [
plate	telero	n. dining plate	w
]

_brusk_ = [
brusquely	bruske	adv.	w
]

_miasm_ = [
miasmal	miasma	adj.	w
]

_sarkasm_ = [
sarcastic	sarkasma	adj.	w
]

_rezerv_ = [
reservoir	rezervujo	n.	w
]

_fizik_ = [
physical	fizika	adj.	w
]

_atrofi_ = [
wasting away	atrofiiĝi	v.ntr	w
]

_redukt_ = [
reduce	redukti	v.tr	w
]

_vertikal_ = [
upright	vertikale	adv.	w
endways	vertikale	adv.	w
]

_aŭspici_ = [
auspicious	aŭspicia	adj.	w
]

_braĝ_ = [
brazier	braĝujo	n.	w
]

_progres_ = [
advance	progresi	v.ntr advance through ranks	w
progress	progreso	n.	w
]

_ŝrump_ = [
shrank	ŝrumpis	v.ntr	w
]

_intermit_ = [
intermittently	intermite	adv. time	w
]

_tort_ = [
pie	torto	n.	w
pies	tortoj	n.	w
]

_ber_ = [
berry	bero	n.	w
]

_drapir_ = [
drapery	drapiraĵo	n. folded, draped clothes	w
]

_ponard_ = [
dagger	ponardo	n. WAR	w
]

_debut_ = [
debut	debuti	v.ntr appear for the first time	w
]

_driv_ = [
drifted	drivis	v.ntr	w
]

_loteri_ = [
drawing	loterio	n.	w
lottery	loterio	n.	w
]

_kontor_ = [
work station	kontoro	n. clerical workplace	w
office	kontoro	n. especially in a factory	w
]

_posten_ = [
position	posteno	n. job, place in the organization hierarchy	
post	posteno	n.	
place	posteno	n. position in a hierarchy	
]

_resoluci_ = [
resolution	resolucio	n. end of disease, vector force addition	w
]

_kanajl_ = [
scoundrel	kanajlo	n. dishonorable person	w
]

_monument_ = [
monument	monumento	n. eg a statue	w
]

_obĵet_ = [
object	obĵeti	v.ntr to object	
]

_tenebr_ = [
tenebrous	tenebra	adj.	w
]

_siluet_ = [
silhouette	silueto	n.	w
]

_heredit_ = [
inherited	heredita	adj.	w
]

_mask_ = [
mask	masko	n.	w
]

_ĝem_ = [
moan	ĝemo	n.	w
]

_pejzaĝ_ = [
landscape	pejzaĝo	n.	w
]

_matric_ = [
matrix	matrico	n.	w
mold	matrico	n.	w
]

_metod_ = [
method	metodo	n.	w
]

_seanc_ = [
meeting	seanco	n.	w
sitting	seanco	n. of parliament; committee; doctor & patient; painter & model; etc	w
séance	spiritista seanco	n.	w
]

_skeptik_ = [
skeptical	skeptika	adj.	w
cynical	skeptika	adj.	w
]

_interes_ = [
interest	intereso	n.	
cared	interesiĝis	v.tr was interested	
drab	seninteresa	adj. uninteresting	w
]

_gener_ = [
regenerated	regenerita	adj.	w
]

_majstr_ = [
master	majstro	n.	w
]

_surfac_ = [
surface	surfaco	n.	w
]

_task_ = [
task	tasko	n.	w
]

_faden_ = [
strand	fadeno	n.	w
thread	fadeno	n.	w
]

_konsult_ = [
consult	konsulti	v.tr	w
see	konsulti	v.tr as in 'see a doctor' for consultation	
]

_noci_ = [
notion	nocio	n.	w
]

_tribun_ = [
reviewing box	tribuno	n.	s
rostrum	tribuno	n.	
pulpit	tribuno	n.	
speaker’s platform	tribuno	n.	
]

_rekompenc_ = [
repay	rekompenci	v.tr a kindness or service	
]

_kapric_ = [
caprice	kaprico	n. change of will	w
]

_lul_ = [
cradled	lulita	adj.	w
]

_flat_ = [
flattering	flata	adj.	w
]

_gliciriz_ = [
licorice	glicirizo	n.	w
]

_bombard_ = [
bombard	bombardi	v.tr WAR	w
]

_rezolut_ = [
determined	rezoluta	adj. resolute	w
]

_kapuĉ_ = [
hooded	kapuĉata	adj. wearing a hood	w
]

_dekoraci_ = [
decorative	dekoracia	adj.	w
]

_kombin_ = [
combine	kombiniĝi	v.ntr become combined	w
]

_tenor_ = [
tenor	tenora	adj.	w
]

_dram_ = [
dramatic	drama	adj.	w
]

_satir_ = [
satire	satiro	n.	w
satirical	satira	adj.	w
]

_silk_ = [
silken	silka	adj.	w
]

_ŝik_ = [
gaudy	malŝika	adj. 	w
]

_konjekt_ = [
speculative	konjekta	adj. based on conjecture	w
]

_koridor_ = [
corridor	koridoro	n.	w
]

_redakci_ = [
editorial office	redakcio	n.	s
]

_golf_ = [
golf	golfo	n.	w
]

_bukl_ = [
curl	buklo	n. of hair	w
ringlet	buklo	n. of hair	w
]

_pug_ = [
buttocks	pugo	n.	w
backside	pugo	n.	w
]

_nervoz_ = [
nervousness	nervozeco	n.	w
nervous	nervoza	adj.  figurative use for anxiety	w
nervously	nervoze	adv.	w
]

_eĥ_ = [
echo	eĥo	n. 	w
]

_merit_ = [
deserve	meriti	v.tr	w
]

_benk_ = [
bench	benko	n.	w
]

_kontant_ = [
cash	kontanto	n. ready cash 	w
]

_proporci_ = [
proportion	proporcio	n. 	w
]

_col_ = [
by inches	je coloj	phr.	w
inch	colo	n.	w
]

_pent_ = [
remorse	pento	n.	w
]

_temperament_ = [
temperament	temperamento	n.	w
]

_jovial_ = [
jovial	joviala	adj.	w
]

_surpriz_ = [
surprise	surprizo	n.	w
]


_leĝer_ = [
lightness	leĝereco	n. nonchalance	w
]

_model_ = [
model	modelo	n.	
pattern	modelo	n. standard, design, or example that can be replicated	w
]

_determin_ = [
determined	determinita	adj.	
]

_nebul_ = [
nebulous	nebula	adj.	w
]

_deĉifr_ = [
undecipherable	nedeĉifrebla	adj.	w
]

_arkaik_ = [
archaic	arkaika	adj.	w
]

_koncept_ = [
conceive	koncepti	v.tr form a concept	w
]

_streb_ = [
strive	strebi	v.ntr	w
]

_plet_ = [
tray	pleto	n.	w
]

_adept_ = [
initiate	adepto	n. new member	w
]

_gol_ = [
goal	golo	n. in football and similar games	w
]

_vilaĝ_ = [
village	vilaĝo	n. 	w
]

_onkl_ = [
uncle	onklo	n.	w
aunt	onklino	n.	w
]

_rim_ = [
rhyming	rimanta	adj.	
]

_skiz_ = [
sketch	skizo	n.	w
]

_surplis_ = [
surplice	surpliso	n. liturgical garment	w
]

_kluz_ = [
sluice	kluzo	n.	w
]

_tradici_ [
tradition	tradicio	n.	w
]

_polis_ = [
insurance policy	poliso	n.	w
]

_koneks_ = [
logically related	koneksa	adj.	s
]

_muld_ = [
mold	muldi	v.tr to mold	w
mold	muldilo	n. a mold	w
]

_pluv_ = [
rain	pluvo	n. 	w
]

_turb_ = [
top	turbo	n. spinny toy	w
]

_merkat_ = [
market	merkato	n. as a system of trading	w
]

_paragraf_ = [
paragraph	paragrafo	n. numbered part of a legal document	w
]

_pavim_ = [
pavement	pavimo	n.	w
]

_petrol_ = [
petroleum	petrolo	n.	w
]

_bros_ = [
brush	broso	n.	w
]

_rimors_ = [
remorse	rimorso	n.	w
]

_superstiĉ_ = [
superstition	superstiĉo	n.	w
]

_glas_ = [
beer glass	bierglaso	n.	w
]

_ĉarm_ = [
darling	ĉarma	adj.	s
]

_mast_ = [
mast	masto	n. maritime	w
]

_ekspedici_ = [
expedition	ekspedicio	n.	w
]

_enket_ = [
inquiry	enketo	n.	w
investigation	enketo	n.	w
inquisition	enketo	n. investigation	w
]

_ŝpat_ = [
spade	ŝpato	n. digging tool	w
]

_parad_ = [
parading	paradante	adv.	w
]

_demisi_ = [
resign	demisii	v.ntr from a position, more formal	w
]

_etaĝ_ = [
floor	etaĝo	n. story of a building	w
story	etaĝo	n. story of a building	w
ground floor	teretaĝo	n.	w
basement	subetaĝo	n.	w
]

_brum_ = [
mist	brumo	n. 	w
]

_tur_ = [
tower	turo	n.	w
]

_dron_ = [
drowned	dronis	v.ntr	
had been drowned	dronis	v.ntr drowned	
]

_bank_ = [
banker	bankisto	n.	w
Tiroler Sparbank	Tirola Ŝparbanko	phr. Tyrolean Savings Bank	s
]

_halo_ = [
halo	haloo	n. in astronomy	w
]

_fask_ = [
bunch	fasko	n.	
]

_negoc_ = [
business	negoco	n. a business	w
commercial transaction	negoco	n.	
]

_kazin_ = [
casino	kazino	n.	w
]

_komplet_ = [
complete	kompleta	adj.	w
]

_konsonant_ = [
consonant	konsonanto	n. not a vowel	w
]

_distil_ = [
distilled	distilita	adj.	w
]

_apetit_ = [
bon appetit	bonan apetiton	phr.	w
]

_kaf_ = [
take coffee	elekti kafon	phr.	s
]

_bulk_ = [
roll	bulko	n. baked good	w
bun	bulko	n.	w
]

_gelaten_ = [
gelatin	gelateno	n. 	w
gelatinous	gelatena	adj. 	w
]

_pat_ = [
frying pan	pato	n.	w
stalemate	pato	n. in chess non-PIV	w
]

_lukt_ = [
wrestle	lukti	v.ntr struggle in unarmed combat	w
]

_kares_ = [
caress	karesi	v.tr
]

_pulvor_ = [
powder	pulvoro	n.	w
]

_procesi_ = [
procession	procesia	adj.	w
pageant	procesio	n. procession	w
]

_paletr_ = [
palette	paletro	n.	w
]

_paŝtel_ = [
crayon	paŝtelo	n.	w
]

_metropol_ = [
metropolis	metropolo	n. 	w
]

_inĝenieri_ = [
engineering	inĝenierio	n. science and department of an engineer	w
]

_ideal_ = [
ideal	idealo	n.	w
idealist	idealisto	n.	w
]

_tromp_ = [
imposture	trompaĵo	n.	w
]

_jubil_ = [
rejoicing	jubilo	n.	w
]

_verm_ = [
worm	vermo	n.	w
]

_paŝt_ = [
graze	paŝtiĝi	v.ntr eat grass	w
shepherd	paŝtisto	n.	
]

_ung_ = [
claw	ungo	n. 	w
claw	ungi	v.tr scratch with nails or claws 	w
clawing	ungogratado	n. 	
]

_hund_ = [
dog	hundo	n. hound	w
]

_pork_ = [
pig	porko	n.	w
pork	porkaĵo	n.	w
]

_rost_ = [
roast	rostita	adj. that has been roasted	v
]

_pan_ = [
bread	pano	n.	w
]

_predik_ = [
sermon	prediko	n.	w
]

_universitat_ = [
university	universitato	n.	w
]

_bird_ = [
bird	birdo	n.	w
]

_vulp_ = [
fox	vulpo	n.	w
]

_lup_ = [
wolf	lupo	n.	w
she-wolf	lupino	n.	w
]

_korn_ = [
horn	korno	n. eg a bull's horn	w
]

_gres_ = [
pasturage	greso	n. grazing material	
]

_skvam_ = [
scaly	skvama	adj.	w
]

_greg_ = [
flock	grego	n. group of the same species	w
]

_sorb_ = [
absorb	sorbi	v.tr draw into oneself and retain	w
blotter	inksorbilo	n.	w
]

_infekt_ = [
infectious	infekta	adj.	w
]

_spasm_ = [
spasm	spasmo	n.	w
]

_adult_ = [
adultery	adulto	n.	w
]

_trapez_ = [
trapeze	trapezo	n.	w
]

_kolos_ = [
colossal	kolosa	adj. 	w
]

_atmosfer_ = [
atmosphere	atmosfero	n. gaseous envirnment, circumstances, unit of pressure	w
]

_pretekst_ = [
adduce	preteksti	v.tr as a pretext	
]

_apr_ = [
boar	apro	n.	w
Boar's Head	Kapo de Apro	n.	s
]

_ĉast_ = [
chaste	ĉasta	adj.	w
]

_kompan_ = [
companion	kompano	n. preferred companions	w
]

_grad_ = [
by degrees	grade	adv.	w
]

_ĝin_  = [
genie	ĝino	n.	w
]

_gargojl_ = [
gargoyle	gargojlo	n.	w
]

_folklor_ = [
lore	folkloro	n. 	w
]

_zom_ = [
zoom	zomi	v.ntr	w
]

_doĝ_ = [
doge	doĝo	n. italian official	w
]

_vigil_ = [
vigil	vigilo	n.	w
]

_vitrin_ = [
case	vitrino	n. display case	w
]

_zum_ = [
hum	zumi	v.tr human produced sound	w
]

_descend_ = [
descent	descendo	n. 	w
descending	descendanta	adj.	w
]

_obskur_ = [
obscure	obskura	adj.	w
]

_bol_ = [
seethe	boli	v.ntr	
]

_pionir_ = [
pioneer	pioniro	n.	w
]

_taŭz_ = [
ruffle	taŭzi	v.tr tousle	w
]

_trib_ = [
tribe	tribo	n.	w
]

_cirkul_ = [
move about	cirkuli	v.ntr	w
]

_reces_ = [
recess	receso	n. a recessed area	w
]

_ton_ = [
tone	tono	n.	w
]

_matur_ = [
matures	maturiĝas	v.ntr	
ripened	maturiĝis	v.ntr	
]

_epitom_ = [
epitomise	epitomiĝi	v.ntr be an epitome	w
]

_palac_ = [
palace	palaco	n.	w
]

_gren_ = [
corn	greno	n. in the sense of a staple grain, not ears of corn	w
]

_mandarin_ = [
mandarin orange	mandarino	n. the fruit not the tree	w
]

_kuz_ = [
cousin	kuzo	n. 	w
cousin	kuzino	n. female	w
]

_kest_ = [
casket	kesteto	n. small chest 	w
]

_imperativ_ = [
imperative	imperativa	adj.	w
]

_horizont_ = [
horizon	horizonto	n.	w
]

_instinkt_ = [
instinct	instinkto	n.	w
instinctive	instinkta	adj.	w
]

_viktim_ = [
victim	viktimo	n.	w
]

_azil_ = [
asylum	azilo	n. for refugees or mental institution	w
retirement community	azilo	n.	w
]

_ulcer_ = [
sore	ulcero	n. lesion with broken skin	w
]

_selen_ = [
solemnity	seleno	n.	w
]

_spontane_ = [
spontaneous	spontanea	adj.	w
]

_instanc_ = [
authority	instanco	n. normally used in the plural	w
authorities	instanco	n. normally used in the plural	w
]

_entrepren_ = [
undertake	entrepreni	v.tr	w
]

_tram_ = [
tram-car	tramo	n.	w
]

_universal_ = [
universal	universala	adj.	w
]

_vaku_ = [
vacua	vakuoj	n. airless spaces	w
]

_venen_ = [
poison	venena	adj. poisonous or venomous	
]

_indiĝen_ = [
native	indiĝeno	n.	w
]

_festival_ = [
festival	festivalo	n. as in “film festival”	w
]

_fetor_ = [
stench	fetoro	n.	w
]

_arom_ = [
fragrant	aroma	adj.	w
]

_ikor_ = [
ichor	ikoro	n.	w
]

_dekret_ = [
decree	dekreti	v.tr	w
]

_girland_ = [
garlanded	girlandita	adj.	w
]

_refer_ = [
report	referi	v.ntr make a research report	
technical report	referaĵo	n.	
professional paper	referaĵo	n.	
]

_resurekt_ = [
resurrection	resurekto	n.	w
]

_rutin_ = [
routine	rutino	n.	w
]

_rar_ = [
rarefied	rara	adj.	w
]

_kviz_ = [
quiz	kvizo	n. esp trivia contest 	w
]

_pulp_ = [
pulp	pulpo	n.	w
]

_imput_ = [
put it on	imputis ĝin al	phr. attribute responsibility	
]

_temerar_ = [
reckless	temerara	adj.	w
]

_ekzekut_ = [
execute	ekzekuti	v.tr capital punishment	w
]

_agoni_ = [
death-throes	agonio	n.	w
]

_akt_ = [
act	akto	n. section of  a play in theater	
]

_aktor_ = [
actor	aktoro	n.	
]

_argument_ = [
argument	argumento	n. point put forward	w
]

_diskurs_ = [
discourse	diskurso	n.	w
]

_komik_ = [
comic	komika	adj.	w
]

_glob_ = [
globe	globo	n.	w
]

_etos_ = [
atmosphere	etoso	n. spiritual atmosphere of a place	w
]

_aŭtomat_ = [
automatic	aŭtomata	adj.	w
]

_blog_ = [
blog	blogo	n. internet blog non-PIV 	w
]

_kondut_ = [
conduct	konduti	v.ntr oneself well or badly	w
]

_ekshibici_ = [
exhibit	ekshibicio	n. [CHECK THIS]	
exhibitionism	ekshibicio	n.	w
]

_sfer_ = [
spheres	sferoj	n. incl the celestial spheres	w
]

_prolog_ = [
prologue	prologo	n.	w
]

_profan_ = [
profane	profani	v.tr pollute a sacred space	
uninitiated person	profano	n.	
religious pollution	profano	n.	
]

_himn_ = [
hymn	himno	n.	w
carol	himno	n. Christmas song	w
]

_karnaval_ = [
mardi mras	karnavalo	n.	w
]

_real_ = [
real	reala	adj. antonymns are imagata & ŝajna	w
unreal	nereala	adj.	w
reality	realo	n.	w
]

_histrion_ = [
comedian	histriono	n. third-rate comedian	
]

_dimensi_ = [
dimension	dimensio	n. 	w
]

_banked_ = [
banquet	bankedo	n.	w
]

_benzin_ = [
gasoline	benzino	n. car fuel	w
]

_abstrakt_ = [
abstraction	abstrakto	n. not short summary	
]

_akĉent_ = [
accent	akĉento	n. of a certain dialect region	w
]

_analiz_ = [
analytical	analiza	adj.	w
]

_izol_ = [
insulated	izolaĵita	adj. coated with electrical insulation	w
]

_matrac_ = [
mattress	matraco	n.	w
]

_nekropol_ = [
necropolis	nekropolo	n.	w
]

_fars_ = [
farce	farso	n.	W
]

_kurten_ = [
curtain	kurteno	n.	w
]

_sepult_ = [
sepulchral	sepulteja	adj.	w
sepulcher	sepultejo	n. burial place	w
]

_kamera_ = [
movie camera	kamerao	n.	w
videocam	kamerao	n.	w
]

_alegori_ = [
allegory	alegorio	n.	w
allegorical	alegoria	adj.	w
]

_pans_ = [
dress	pansi	v.tr to dress a wound	w
]

_kopulaci_ = [
copulation	kopulacio	n.	w
]

_alfabet_ = [
alphabet	alfabeto	n.	w
]

_volum_ = [
volume	volumo	n. book in a collection	w
]

_drog_ = [
drug	drogo	n.	w
]

_idiot_ = [
idiotic	idiota	adj.	w
]

_av_ = [
grandam	avino	n. grandmother	w
]

_nev_ = [
nephew	nevo	n.	w
niece	nevino	n.	w
]

_efektiv_ = [
actual	efektiva	adj. actually existing	w
affect	efektivigi	v.tr to bring about, to effect	w
bring about	efektivigi	v.tr	w
genuinely	efektive	adv. really, actually, indeed	w
existing	efektiva	adj. actually existing	w
really	efektive	adv. real, not imagined	w
effect	efektivigi	v.tr bring about	w
actually	efektive	adv.	w
]

_ŝajn_ = [
appear	ŝajni	v.ntr to seem	w
apparent	ŝajna	adj. ant=reala	w
apparently	ŝajne	adv. seemingly	w
what seemed	ŝajne	adv.	
seemed	ŝajnis	v.ntr	
struck him	ŝajnis al li	phr. seemed to him	
it seemed	tiel ŝajnis	phr.	
probable	verŝajna	adj.	w
apparently	verŝajne	adv. In all probability	w
probably	verŝajne	adv. In all probability vs eventuale which is more 'possibly'	w
seemingly	verŝajne	adv. In all probability	w
unlikely	neverŝajna	adj.	w
hardly	malverŝajne	adv. are very unlikely to	w
make it seem as though	ŝajnigi	v.tr	
pretend	ŝajnigi	v.tr	w
pretence	ŝajnigo	n. act of one who pretends	w
assumed	ŝajniga	adj. feigned	w
pretending	ŝajnigante	adv.	
]

_kamizol_ = [
doublet	kamizolo	n. Renaissance or Elizabethan close-fitting, often padded jacket worn over the shirt	w
]

_indiferent_ = [
indifference	indiferenteco	n.	w
]

_irit_ = [
irritating	iritanta	adj.	w
irritability	iritiĝebleco	n.	w
irritably	iritiĝeblece	adv.	w
]

_karier_ = [
career	kariero	n.	w
]

_energi_ = [
listless	senenergia	adj.	w
]

_butik_ = [
market	butikejo	n. set of shops	s
]

_melodi_ = [
melody	melodio	n. musical	w
tune	melodio	n.	w
]

_dubl_ = [
dub	dubli	v.tr dub a film	w
]

_akcent_ = [
accent	akcento	n. stress on a syllable; musical accent	w
accentuate	akcenti	v.tr	w
]

_detal_ = [
in detail	detale	adv. in a detailed manner	w
]

_fabel_ = [
tale	fabelo	n. fictional story, compare to rakonto:story and fablo:fable esp per Aesop	w
]

_raci_ = [
reason	racio	n. that rational part of the mind	w
]

_klif_ = [
cliff	klifo	n. high coastal cliff	w
]

_recit_ = [
recite	reciti	v.tr 	w
]

_hord_ = [
horde	hordo	n. 	w
]

_elast_ = [
flexible	elasta	adj. deformable, elastic	w
]

_eskal_ = [
ladder	eskalo	n.	w
]

_stumbl_ = [
stumble	stumbli	v.ntr	w
]

_popol_ = [
populate	popoli	v.tr	w
people	popoli	v.tr provide a population	w
people	popolo	n. populace	w
]

_nutr_ = [
fostered	nutrita	adj. 	
]

_kotiz_ = [
fee	kotizo	n.	w
]

_nepr_ = [
perforce	nepre	adv.	w
]

_brod_ = [
embroidery	brodaĵo	n.	w
embroider	brodi	v.tr	w
]

_establ_ = [
established	establita	adj.	w
]

_boks_ = [
shadowbox	ombra-boksi	v.ntr 	w
]

_klimaks_ = [
anticlimax	malklimakso	n.	w
]

_ident_ = [
might mistake	misidentigus	v.tr	s
]

_akrid_ = [
locust	akrido	n.	w
grasshopper	akrido	n.	w
]

_gru_ = [
crane	gruo	n. both bird and machine	w
]

_desert_ = [
dessert	deserto	n.	w
]

_vers_ = [
couplet	duversaĵo	n.	w
]

_ŝtal_ = [
steel	ŝtalo	n.	w
]

_impotent_ = [
impotent	impotenta	adj.	w
]

_tinktur_ = [
tinged	tinkturetita	adj. lit slightly colored by dying	w
]

_kulmin_ = [
climax	kulmino	n.	w
]

_kontakt_ = [
contact	kontakto	n.	w
]

_nova_ = [
nova	novao	n. astronomy	w
]

_popular_ = [
popular	populara	adj.	w
]


_kvadrat_ = [
square	kvadrato	n.	w
]

_sensaci_ = [
sensational	sensacia	adj.	w
]

_profesi_ = [
professional	profesia	adj.	w
]

_magazin_ = [
magazine	magazino	n. popular magazine (for amusement)	w
]

_gej_ = [
gay	geja	adj. homosexual	w
homosexual	geja	adj.	w
]

_frontispic_ = [
frontispiece	frontispico	n.	w
]

_komisi_ = [
special delegate	komisiito	n.	
committee chair	komisiito	n.	
]

_sozi_ = [
double	sozio	n. in the sense of a doppelganger	s
]

_diskont_ = [
discount	diskonto	n. on financial instruments 	
]

_adolt_ = [
adult	adolto	n. one fully grown	w
]

_fianĉ_ = [
engaged to be married	fianĉiĝita	adj.	w
]

_miel_ = [
honey	mielo	n.	w
]

_visk_ = [
mistletoe	visko	n.	w
]

_konus_ = [
fir cone	abia konuso	n.	w
]

_gazon_ = [
lawn	gazono	n. decorative lawn	
]

_ĝarden_ = [
garden	ĝardeno	n. 	w
]

_okul_ = [
eye	okulo	n.	w
eyes downcast	okuloj rigardantaj malsupren	phr.	w
with closed eyes	okulfermite	adv.	s
]

_frunt_ = [
forehead	frunto	n.	w
brow	frunto	n. forehead	w
]

_piĉ_ = [
pitch	piĉo	n. musical	
female genitalia	piĉo	n.	w
]

_tamburin_ = [
tambourine	tamburino	n.	w
]

_tambur_ = [
drum	tamburo	n.	w
]

_karakter_ = [
character	karaktero	n.	w
]

_reflekt_ = [
reflection	reflekto	n. optical as a mirror	w
]

_febl_ = [
feeble	febla	adj. weak	w
]

_pneŭmat_ = [
pneumatic	pneŭmata	adj.	w
]

_flirt_ = [
flit	flirti	v.ntr	w
]

_manifest_ = [
manifest	manifesti	v.tr	w
]

_ŝip_ = [
ship	ŝipo	n.	w
]

_obstakl_ = [
hurdle	obstaklo	n. obstacle	w
]

_trup_ = [
troops	trupoj	n. 	w
]

_fragment_ = [
fragment	fragmento	n.	w
]

_paleontolog_ = [
paleontologist	paleontologo	n. 	w
paleontology	paleontologio	n. 	w
]

_eter_ = [
ethereal	etera	adj.	w
]

_nomad_ = [
nomad	nomado	n.	w
]

_dorlot_ = [
pamper	dorloti	v.tr	w
]

_eminent_ = [
prominence	eminenteco	n.	w
]

_grafiti_ = [
graffiti	grafitio	n. 	w
]

_trezor_ = [
treasury	trezorejo	n. MONEY	w
treasure-vault	trezorkelo	n. lit. treasure cellar	w
]

_brik_ = [
brick	briko	n.	w
]

_debitor_ = [
debtor	debitoro	n.	w
]

_asemble_ = [
assembly	asembleo	n. governing body	w
]

_inkluziv_ = [
include	inkluzivi	v.tr	w
]

_barelief_ = [
bas-relief	bareliefo	n. 	w
]

_dekadenc_ = [
decadence	dekadenco	n. 	w
]

_fekund_ = [
fertile	fekunda	adj.	w
]

_klink_ = [
latch	klinko	n.	w
]

_epizod_ = [
episode	epizodo	n.	w
]

_nest_ = [
nest	nesto	n.	w
]

_simi_ = [
ape	simio	n. any monkey or similar	w
]

_kuk_ = [
cake	kuko	n.	w
]

_dorn_ = [
thorn	dorno	n.	w
]

_oranĝeri_ = [
greenhouse	oranĝerio	n.	w
conservatory	oranĝerio	n.	
]

_digest_ = [
indigestible	nedigestebla	adj.	w
]

_impuls_ = [
impulse	impulso	n.	w
]

_moroz_ = [
brooding	moroza	adj.	w
]

_vesper_ = [
evening	vespero	n. time	w
good evening	bonan vesperon	phr. greeting	w
]

_maten_ = [
morning	mateno	n.	
in the morning	matene	adv.	
this morning	ĉi matene	adv.	
]

_minut_ = [
minute	minuto	n.	w
]

_sekund_ = [
every few seconds	ĉiuj kelkaj sekundoj	phr.	
]

_jar_ = [
year	jaro	n.	w
century	jarcento	n.	w
a year	ĉiujare	adv. yearly	w
all these years	ĉiuj ĉi tiuj jaroj	phr.	
years ago	antaŭ jaroj	phr.	
age about 25	ĉirkaŭ 25-jaraĝa	phr.	
30	30-jara	adj. years of age	
]

_blu_ = [
blue	blua	adj.	w
]

_general_ = [
general	generalo	n. rank	w
]

_ans_ = [
handle	anso	n.	w
]

_koher_ = [
incoherent	nekohera	adj.	w
]

_kvalit_ = [
quality	kvalito	n.	W
]

_tondr_ = [
boomed	tondris	v.ntr	
]

_kiras_ = [
ironclad	kirasa	adj.	w
]

_ŝancel_ = [
wavering	ŝancelanta	adj.	w
]

_strek_ = [
underline	substreki	v.tr	w\
]

_promoci_ = [
promotion	promocio	n. receiving a higher rank	
]

_parenc_ = [
relative	parenco	n. a relative	w
]

_fost_ = [
low-studded	kun malaltaj fostoj	phr. ceiling supported by short studs	w
]

_paĉj_ = [
daddy	paĉjo	n.	
papa	paĉjo	n. father	w
]

_jup_ = [
skirt	jupo	n.	w
]

_spekul_ = [
speculative	spekula	adj. financially	w
]

_katun_ = [
cotton	katuno	n. cloth	
]

_proces_ = [
lawsuit	proceso	n.	w
]

_koŝmar_ = [
nightmare	koŝmaro	n.	w
]

_satirus_ = [
satyr	satiruso	n.	w
]

_silf_ = [
sylph	silfino	n.	w
]

_ciklop_ = [
cyclopean	ciklopa	adj. 	w
]

_ĥul_ = [
ghoul	ĥulo	n. non-PIV, CHECK 	w
]

_ŝim_ = [
mold	ŝimo	n.	
mildew	ŝimo	n. 	w
]

_rezoluci_ = [
resolution	rezolucio	n. declaration of a committee	w
]

_arme_ = [
army	armeo	n. 	w
]

_grajl_ = [
sleet	grajlo	n. WEATHER	w
]

_vitr_ = [
glasses	okulvitroj	n. eyeglasses	w
]

_surtut_ = [
overcoat	surtuto	n.	w
]

_fleg_ = [
nurse	flegistino	n.	
]

_liter_ = [
typefont	literaro	n.	
]

_intim_ = [
intimately	intime	adv.	w
]

_muk_ = [
mucus	muko	n.	w
]
_kava_ = [
kava	kavao	n.	w
]

_psik_ = [
psychology	psikologio	n.	
]

_gruz_ = [
gravel	gruzo	n.	w
]

_volb_ = [
vault	volbo	n. arched ceiling	w
]

_ras_ = [
race	raso	n. ethnicity	w
ancient race	pra-raso	n.	s
]

