body	korpo	n.	
bodily	korpa	adj.	
physical	korpa	adj. bodily, use 'fizika' when technical	w
physically	korpe	adj. bodily, use 'fizike' when technical	

blood	sango	n.	
thin-blooded	malfortik'sanga	adj.	

organ	organo	n. body part	


head	kapo	n.	
nod	kapjeso	n.	w

hair	hararo	a set of hair	w
hair	haro	a hair	w
curl	buklo	n. of hair	w
ringlet	buklo	n. of hair	w

face	vizaĝo	n. front of head	
facial	vizaĝa	adj.	w
on his face	en lia vizaĝo	phr.

forehead	frunto	n.	w
brow	frunto	n. forehead	
brow	brovo	n. eyebrow	
eyebrow	brovo	n.	
cheek	vango	n.	
mouth	buŝo	n.	
mucous membrane	mukozo	n.	

skull	kranio	n.	w
cranium	kranio	n.	
brain	cerbo	n.

eye	okulo	n.	
eye-socket	kavo	n.	
eyes downcast	okuloj rigardantaj malsupren	phr.	w

neck	kolo	n.	
lip	lipo	n.	
heart	koro	n.	

shoulder	ŝultro	n.	
shoulder	surŝultrigi	v.tr put up on the shoulder	w

arm	brako	n.	W
back	dorso	anatomical	w

female genitalia	piĉo	n.	
knee	genuo	n.	w

belly	ventro	n.	
buttocks	pugo	n.	

foot	piedo	n.	
hand	mano	n. at the ends of the arm	w
hands	manoj	n. at the ends of the arms	w
palm	manplato	n. as in the palm of the hand	
finger	fingro	n.
nose	nazo	n.	
nostril	naztruo	n.	
backside	pugo	n.	
ear	orelo	n.	
muscle	muskolo	n.	
testicle	testiko	n.	
waist	talio	n.	


# ADJECTIVES
big-boned	grand’osta	adj.	
hearty	elkora	adj.	w
heartfelt	elkora	adj.	w