Mr.	S-ro	abbr. sinjoro	
Mrs.	S-ino	abbr. sinjoro	
sir	sinjoro	n.	
madam	sinjorino	n.	

John	Johano	n. name	
Thos.	Tomaso	n. name	
Smith	Smito	n. family name	
Phillip	Filipo	n. name	
Browne	Bra≈≠no	n. family name	
Marco	Marko	person's name	
Miller	Milero	n. name	
Cosimo	Kosimo	n. personal-name	
Ogilvie	Ogilvio	n. family name	
George	Georgo	n. name
Mary	Marjo	n. name

# SPECIFIC
Whittier	Vitiero	n.	
Wynkin de Worde	Vinko Devordo	n.	
Bodleian	de Bodlejo	n.	
Lattin	Latino	n. name	


