'=== PLACES ===		
Alexandria	Aleksandrio	PIV
England	Anglio	
Egypt	Egiptujo	
Florence	Florenco	Italian city
Greece	Grekio	
Meran	Merano	
John o’ Groats	Johano de Kvar'pencoj	proper noun, place
Land’s End	Terfino	proper noun, place
'=== OTHER ===		
Apollo	Apolono	PIV
Bodleian	de Bodlejo	
Hesperides	Hesperidoj	
Jesus	Jesuo	
John	Johano	name
Miller	Milero	Family-name
Samos	Samoso	PIV, Greek island
Thos.	Tomaso	Personal-name
Wynkin de Worde	Vinko Devordo	
Whittier	Vitiero	
Gaudeamus Omnes	Ni Ĉiuj Ĝoju	Chant, Latin: Let us all Rejoice
